,SA2_MAIN16,STE_NAME16,liberal/national coalition votes,australian labor party votes,totalvotes
0,101021007,New South Wales,655,850,1505
1,101021008,New South Wales,600,937,1537
2,101021009,New South Wales,7954,9937,17891
3,101021010,New South Wales,756,1040,1796
4,101021011,New South Wales,3023,3052,6075
5,101021012,New South Wales,1818,1772,3590
6,101031013,New South Wales,633,404,1037
7,101031014,New South Wales,3313,2584,5897
8,101031015,New South Wales,369,234,603
9,101031016,New South Wales,1794,1315,3109
10,101041017,New South Wales,5083,4898,9981
11,101041018,New South Wales,1307,1431,2738
12,101041019,New South Wales,3119,3932,7051
13,101041020,New South Wales,1257,1836,3093
14,101041021,New South Wales,645,831,1476
15,101041023,New South Wales,906,695,1601
16,101041024,New South Wales,435,516,951
17,101041025,New South Wales,3918,3556,7474
18,101041026,New South Wales,1487,2055,3542
19,101041027,New South Wales,2866,3268,6134
20,101051539,New South Wales,10432,7158,17590
21,101051540,New South Wales,2597,1298,3895
22,101061541,New South Wales,2767,2661,5428
23,101061542,New South Wales,2479,2132,4611
24,101061543,New South Wales,5313,2192,7505
25,101061544,New South Wales,1835,931,2766
26,102011028,New South Wales,1277,1338,2615
27,102011029,New South Wales,1247,1155,2402
28,102011030,New South Wales,1282,742,2024
29,102011031,New South Wales,3908,2720,6628
30,102011032,New South Wales,8860,7618,16478
31,102011033,New South Wales,1422,1273,2695
32,102011034,New South Wales,6440,4642,11082
33,102011035,New South Wales,715,621,1336
34,102011036,New South Wales,951,851,1802
35,102011037,New South Wales,1115,1169,2284
36,102011038,New South Wales,1563,1012,2575
37,102011039,New South Wales,4171,3212,7383
38,102011040,New South Wales,3794,4250,8044
39,102011041,New South Wales,2289,1553,3842
40,102011042,New South Wales,8060,7885,15945
41,102011043,New South Wales,2085,2578,4663
42,102021044,New South Wales,3784,4233,8017
43,102021045,New South Wales,1353,2376,3729
44,102021046,New South Wales,1760,2165,3925
45,102021047,New South Wales,2865,3087,5952
46,102021048,New South Wales,3232,4578,7810
47,102021049,New South Wales,551,472,1023
48,102021050,New South Wales,2124,2242,4366
49,102021051,New South Wales,872,795,1667
50,102021052,New South Wales,1431,1400,2831
51,102021053,New South Wales,8058,7641,15699
52,102021054,New South Wales,1623,2046,3669
53,102021055,New South Wales,959,1161,2120
54,102021056,New South Wales,7958,8670,16628
55,102021057,New South Wales,5749,6060,11809
56,103011058,New South Wales,13408,8697,22105
57,103011059,New South Wales,1233,932,2165
58,103011060,New South Wales,1099,566,1665
59,103011061,New South Wales,1229,599,1828
60,103021062,New South Wales,2162,788,2950
61,103021063,New South Wales,4562,2065,6627
62,103021064,New South Wales,1456,480,1936
63,103021065,New South Wales,4325,1406,5731
64,103021066,New South Wales,1446,393,1839
65,103021067,New South Wales,4932,1947,6879
66,103021068,New South Wales,799,337,1136
67,103021069,New South Wales,2630,518,3148
68,103031070,New South Wales,5347,4100,9447
69,103031071,New South Wales,1781,1098,2879
70,103031072,New South Wales,7251,3585,10836
71,103031073,New South Wales,925,611,1536
72,103031074,New South Wales,1645,828,2473
73,103041076,New South Wales,2238,1076,3314
74,103041077,New South Wales,15145,8407,23552
75,103041078,New South Wales,1734,993,2727
76,103041079,New South Wales,3271,1246,4517
77,104011080,New South Wales,10753,5820,16573
78,104011081,New South Wales,2261,1231,3492
79,104011082,New South Wales,7084,3900,10984
80,104021083,New South Wales,881,1871,2752
81,104021084,New South Wales,2283,1677,3960
82,104021085,New South Wales,13156,8515,21671
83,104021086,New South Wales,769,558,1327
84,104021087,New South Wales,812,613,1425
85,104021088,New South Wales,1283,909,2192
86,104021089,New South Wales,4450,3175,7625
87,104021090,New South Wales,1303,1100,2403
88,104021091,New South Wales,3415,2817,6232
89,105011092,New South Wales,794,650,1444
90,105011093,New South Wales,1429,709,2138
91,105011094,New South Wales,841,837,1678
92,105011095,New South Wales,1616,647,2263
93,105011096,New South Wales,1313,994,2307
94,105021097,New South Wales,3982,6696,10678
95,105021098,New South Wales,164,308,472
96,105031099,New South Wales,2266,1564,3830
97,105031100,New South Wales,2796,1374,4170
98,105031101,New South Wales,14502,5890,20392
99,105031102,New South Wales,1214,567,1781
100,105031103,New South Wales,500,165,665
101,105031104,New South Wales,1294,500,1794
102,105031105,New South Wales,1927,716,2643
103,105031106,New South Wales,2467,1273,3740
104,106011107,New South Wales,1813,1876,3689
105,106011108,New South Wales,6631,8331,14962
106,106011109,New South Wales,1110,1295,2405
107,106011110,New South Wales,2767,1629,4396
108,106011111,New South Wales,3656,6908,10564
109,106011112,New South Wales,5809,5297,11106
110,106011113,New South Wales,669,461,1130
111,106021114,New South Wales,910,1464,2374
112,106021115,New South Wales,11553,13925,25478
113,106021116,New South Wales,1692,1404,3096
114,106021117,New South Wales,5295,7736,13031
115,106021118,New South Wales,1761,2378,4139
116,106031119,New South Wales,900,931,1831
117,106031120,New South Wales,1396,1535,2931
118,106031121,New South Wales,8967,6649,15616
119,106031122,New South Wales,6087,7047,13134
120,106031123,New South Wales,1322,858,2180
121,106031124,New South Wales,1745,908,2653
122,106031125,New South Wales,2880,2866,5746
123,106041126,New South Wales,5051,4537,9588
124,106041127,New South Wales,525,494,1019
125,106041128,New South Wales,2028,903,2931
126,106041129,New South Wales,1855,812,2667
127,107011131,New South Wales,7152,14137,21289
128,107011132,New South Wales,841,1719,2560
129,107011134,New South Wales,2292,3765,6057
130,107011545,New South Wales,1167,4155,5322
131,107011546,New South Wales,1003,3033,4036
132,107011547,New South Wales,525,1016,1541
133,107031136,New South Wales,2190,3796,5986
134,107031137,New South Wales,708,1546,2254
135,107031138,New South Wales,4185,4331,8516
136,107031139,New South Wales,897,1100,1997
137,107031140,New South Wales,1513,1592,3105
138,107031141,New South Wales,2453,3653,6106
139,107031142,New South Wales,1503,2973,4476
140,107031143,New South Wales,7641,15296,22937
141,107041144,New South Wales,2845,4691,7536
142,107041145,New South Wales,5827,10785,16612
143,107041146,New South Wales,3359,5302,8661
144,107041147,New South Wales,1875,2294,4169
145,107041148,New South Wales,1773,3409,5182
146,107041150,New South Wales,2954,5571,8525
147,107041548,New South Wales,7592,12023,19615
148,107041549,New South Wales,1143,2645,3788
149,108011151,New South Wales,1246,756,2002
150,108011152,New South Wales,8947,4439,13386
151,108011153,New South Wales,1534,1050,2584
152,108011154,New South Wales,1134,621,1755
153,108021155,New South Wales,7892,4023,11915
154,108021156,New South Wales,1655,961,2616
155,108021157,New South Wales,1589,873,2462
156,108021158,New South Wales,3328,2244,5572
157,108021159,New South Wales,1687,1248,2935
158,108021160,New South Wales,1501,751,2252
159,108031161,New South Wales,72,132,204
160,108041162,New South Wales,6673,3292,9965
161,108041163,New South Wales,17326,8102,25428
162,108041164,New South Wales,3738,1842,5580
163,108041165,New South Wales,1276,411,1687
164,108041166,New South Wales,4859,1843,6702
165,108051167,New South Wales,1734,759,2493
166,108051168,New South Wales,2227,1396,3623
167,108051169,New South Wales,12112,6269,18381
168,108051170,New South Wales,2997,1600,4597
169,108051171,New South Wales,1628,889,2517
170,109011172,New South Wales,2207,1306,3513
171,109011173,New South Wales,2100,1386,3486
172,109011174,New South Wales,12576,6567,19143
173,109011175,New South Wales,3580,1203,4783
174,109011176,New South Wales,3138,2074,5212
175,109021177,New South Wales,870,373,1243
176,109021178,New South Wales,1437,548,1985
177,109021179,New South Wales,774,214,988
178,109031180,New South Wales,2672,1109,3781
179,109031181,New South Wales,1783,714,2497
180,109031182,New South Wales,3544,1426,4970
181,109031183,New South Wales,1635,523,2158
182,109031184,New South Wales,966,340,1306
183,109031185,New South Wales,3155,1098,4253
184,110011186,New South Wales,9139,6610,15749
185,110011187,New South Wales,1097,371,1468
186,110011188,New South Wales,1298,790,2088
187,110011189,New South Wales,1252,216,1468
188,110021190,New South Wales,3679,1352,5031
189,110021191,New South Wales,6176,2205,8381
190,110021192,New South Wales,1096,359,1455
191,110021193,New South Wales,1796,439,2235
192,110021194,New South Wales,2428,979,3407
193,110031195,New South Wales,4075,1046,5121
194,110031196,New South Wales,950,250,1200
195,110031197,New South Wales,4089,1162,5251
196,110031198,New South Wales,1174,271,1445
197,110041199,New South Wales,5058,1640,6698
198,110041200,New South Wales,918,267,1185
199,110041201,New South Wales,2377,1176,3553
200,110041202,New South Wales,4175,2381,6556
201,110041203,New South Wales,13820,6382,20202
202,110041204,New South Wales,1435,861,2296
203,110041205,New South Wales,4670,1774,6444
204,111011206,New South Wales,7058,7729,14787
205,111011207,New South Wales,863,1189,2052
206,111011208,New South Wales,11214,13799,25013
207,111011209,New South Wales,3657,5524,9181
208,111011210,New South Wales,1203,2342,3545
209,111011211,New South Wales,694,847,1541
210,111011212,New South Wales,2344,2965,5309
211,111011213,New South Wales,2929,2473,5402
212,111011214,New South Wales,3008,3265,6273
213,111021215,New South Wales,1370,2314,3684
214,111021216,New South Wales,1356,1458,2814
215,111021217,New South Wales,3459,5067,8526
216,111021218,New South Wales,5867,4471,10338
217,111021219,New South Wales,5509,6366,11875
218,111021220,New South Wales,1577,1837,3414
219,111021221,New South Wales,1311,1944,3255
220,111031222,New South Wales,2745,4268,7013
221,111031223,New South Wales,1131,2259,3390
222,111031224,New South Wales,1137,2710,3847
223,111031225,New South Wales,3216,5416,8632
224,111031226,New South Wales,1600,2970,4570
225,111031227,New South Wales,1850,4819,6669
226,111031228,New South Wales,3568,4192,7760
227,111031229,New South Wales,6911,10557,17468
228,111031231,New South Wales,1070,2870,3940
229,111031232,New South Wales,1352,1991,3343
230,111031233,New South Wales,6483,11681,18164
231,111031234,New South Wales,918,2510,3428
232,111031235,New South Wales,979,3091,4070
233,112011236,New South Wales,8074,7388,15462
234,112011237,New South Wales,3065,2394,5459
235,112011238,New South Wales,688,1730,2418
236,112011239,New South Wales,932,2644,3576
237,112011240,New South Wales,2067,5074,7141
238,112011241,New South Wales,1571,954,2525
239,112011242,New South Wales,1011,1462,2473
240,112011243,New South Wales,925,3086,4011
241,112021244,New South Wales,6571,3189,9760
242,112021245,New South Wales,1339,728,2067
243,112021246,New South Wales,1815,1491,3306
244,112021247,New South Wales,1864,1258,3122
245,112021248,New South Wales,10436,9364,19800
246,112021249,New South Wales,1959,2853,4812
247,112031250,New South Wales,3525,3405,6930
248,112031251,New South Wales,3766,4307,8073
249,112031252,New South Wales,1393,1730,3123
250,112031253,New South Wales,1873,2566,4439
251,112031254,New South Wales,9144,7465,16609
252,112031550,New South Wales,2576,2244,4820
253,112031551,New South Wales,647,419,1066
254,112031552,New South Wales,4761,4453,9214
255,113011256,New South Wales,7900,3062,10962
256,113011257,New South Wales,3407,1016,4423
257,113011258,New South Wales,3681,1634,5315
258,113011259,New South Wales,2150,976,3126
259,113021260,New South Wales,827,676,1503
260,113021261,New South Wales,2695,2498,5193
261,113021262,New South Wales,553,490,1043
262,113031263,New South Wales,3184,1829,5013
263,113031264,New South Wales,1064,704,1768
264,113031265,New South Wales,1501,637,2138
265,113031266,New South Wales,2842,782,3624
266,113031267,New South Wales,4497,2042,6539
267,113031268,New South Wales,1581,836,2417
268,113031269,New South Wales,3702,2462,6164
269,113031270,New South Wales,13782,6787,20569
270,113031271,New South Wales,4441,1542,5983
271,114011272,New South Wales,1751,1859,3610
272,114011273,New South Wales,735,901,1636
273,114011274,New South Wales,982,1221,2203
274,114011276,New South Wales,2430,3131,5561
275,114011277,New South Wales,2130,2476,4606
276,114011278,New South Wales,10577,11622,22199
277,114011279,New South Wales,1756,2634,4390
278,114011280,New South Wales,1006,1052,2058
279,114011281,New South Wales,601,684,1285
280,114011282,New South Wales,6285,6693,12978
281,114011283,New South Wales,415,655,1070
282,114021284,New South Wales,9442,6438,15880
283,114021285,New South Wales,1527,1065,2592
284,114021286,New South Wales,1650,1649,3299
285,114021287,New South Wales,1738,1548,3286
286,114021288,New South Wales,830,719,1549
287,114021289,New South Wales,1179,996,2175
288,115011290,New South Wales,17987,8256,26243
289,115011291,New South Wales,5746,2707,8453
290,115011294,New South Wales,1797,461,2258
291,115011296,New South Wales,3208,1336,4544
292,115011553,New South Wales,1502,700,2202
293,115011554,New South Wales,2437,1032,3469
294,115011555,New South Wales,5708,2457,8165
295,115011556,New South Wales,1343,580,1923
296,115011558,New South Wales,7546,3437,10983
297,115011559,New South Wales,8283,3367,11650
298,115021297,New South Wales,7015,1745,8760
299,115021298,New South Wales,1809,593,2402
300,115031299,New South Wales,458,435,893
301,115031300,New South Wales,6242,3187,9429
302,115041301,New South Wales,3428,991,4419
303,115041302,New South Wales,7891,2965,10856
304,116011303,New South Wales,9136,14436,23572
305,116011304,New South Wales,2281,3386,5667
306,116011306,New South Wales,2728,4754,7482
307,116011307,New South Wales,4957,5228,10185
308,116011308,New South Wales,3553,4963,8516
309,116011560,New South Wales,1730,2707,4437
310,116011561,New South Wales,2036,2923,4959
311,116021309,New South Wales,2696,3629,6325
312,116021310,New South Wales,12721,10547,23268
313,116021312,New South Wales,4010,3251,7261
314,116021562,New South Wales,941,1027,1968
315,116021563,New South Wales,3360,3679,7039
316,116031313,New South Wales,1699,3912,5611
317,116031314,New South Wales,1712,2676,4388
318,116031315,New South Wales,2126,4353,6479
319,116031316,New South Wales,2665,4570,7235
320,116031317,New South Wales,2279,4743,7022
321,116031319,New South Wales,7910,12636,20546
322,117011321,New South Wales,1334,2404,3738
323,117011322,New South Wales,5322,8804,14126
324,117011323,New South Wales,2015,3232,5247
325,117021326,New South Wales,4405,15210,19615
326,117021327,New South Wales,1752,7174,8926
327,117021328,New South Wales,612,2397,3009
328,117031329,New South Wales,1679,3027,4706
329,117031330,New South Wales,1111,4330,5441
330,117031331,New South Wales,2283,6774,9057
331,117031332,New South Wales,1864,9983,11847
332,117031333,New South Wales,3209,5206,8415
333,117031334,New South Wales,1661,2258,3919
334,117031335,New South Wales,1327,3989,5316
335,117031336,New South Wales,1596,4675,6271
336,117031337,New South Wales,18354,23516,41870
337,117031338,New South Wales,2976,4904,7880
338,118011339,New South Wales,2712,3071,5783
339,118011340,New South Wales,2930,3108,6038
340,118011341,New South Wales,10204,6728,16932
341,118011343,New South Wales,5841,2699,8540
342,118011344,New South Wales,1197,321,1518
343,118011345,New South Wales,5133,4574,9707
344,118011346,New South Wales,7651,2519,10170
345,118011347,New South Wales,1448,989,2437
346,118021348,New South Wales,4093,5496,9589
347,118021350,New South Wales,3240,5044,8284
348,118021564,New South Wales,1523,1916,3439
349,118021565,New South Wales,1123,1373,2496
350,118021566,New South Wales,5637,6788,12425
351,118021567,New South Wales,1924,2986,4910
352,118021568,New South Wales,768,1156,1924
353,118021569,New South Wales,6965,8587,15552
354,118021570,New South Wales,1337,2035,3372
355,119011354,New South Wales,3072,4590,7662
356,119011356,New South Wales,1502,2326,3828
357,119011357,New South Wales,2870,5575,8445
358,119011358,New South Wales,7831,5829,13660
359,119011359,New South Wales,6187,4722,10909
360,119011360,New South Wales,3127,2928,6055
361,119011361,New South Wales,1500,3337,4837
362,119011571,New South Wales,1102,2645,3747
363,119011572,New South Wales,4858,10663,15521
364,119021362,New South Wales,5044,8595,13639
365,119021363,New South Wales,3126,5944,9070
366,119021364,New South Wales,4235,5822,10057
367,119021366,New South Wales,1624,3011,4635
368,119021367,New South Wales,1969,2717,4686
369,119021573,New South Wales,865,2993,3858
370,119021574,New South Wales,536,1991,2527
371,119031368,New South Wales,13164,10378,23542
372,119031369,New South Wales,4841,3906,8747
373,119031370,New South Wales,2025,1907,3932
374,119031371,New South Wales,3272,2580,5852
375,119031372,New South Wales,5105,3360,8465
376,119031373,New South Wales,1760,2094,3854
377,119031374,New South Wales,4922,2473,7395
378,119041375,New South Wales,2039,3722,5761
379,119041376,New South Wales,2891,4072,6963
380,119041377,New South Wales,2577,3182,5759
381,119041378,New South Wales,1216,1575,2791
382,119041379,New South Wales,3119,2768,5887
383,119041380,New South Wales,2065,2128,4193
384,119041381,New South Wales,6667,9208,15875
385,119041382,New South Wales,5933,3481,9414
386,120011383,New South Wales,11661,7905,19566
387,120011384,New South Wales,4083,3819,7902
388,120011385,New South Wales,4503,3744,8247
389,120011386,New South Wales,4666,3969,8635
390,120021387,New South Wales,1884,3749,5633
391,120021388,New South Wales,5066,13146,18212
392,120021389,New South Wales,2390,4918,7308
393,120031390,New South Wales,6400,11177,17577
394,120031391,New South Wales,3624,4282,7906
395,120031392,New South Wales,1547,3334,4881
396,120031393,New South Wales,2587,3257,5844
397,120031394,New South Wales,1083,4824,5907
398,120031395,New South Wales,1908,4173,6081
399,120031396,New South Wales,1554,2406,3960
400,120031575,New South Wales,3900,2431,6331
401,120031576,New South Wales,569,645,1214
402,121011398,New South Wales,10113,6396,16509
403,121011399,New South Wales,3415,2808,6223
404,121011400,New South Wales,7291,5115,12406
405,121011401,New South Wales,1550,1290,2840
406,121011402,New South Wales,8526,4715,13241
407,121021403,New South Wales,4132,3151,7283
408,121021404,New South Wales,3025,2607,5632
409,121021406,New South Wales,6194,4004,10198
410,121021577,New South Wales,1848,1599,3447
411,121021578,New South Wales,10125,6597,16722
412,121021579,New South Wales,1011,732,1743
413,121031407,New South Wales,4273,2333,6606
414,121031408,New South Wales,8171,4279,12450
415,121031409,New South Wales,6316,3405,9721
416,121031410,New South Wales,10357,3623,13980
417,121031411,New South Wales,4151,2283,6434
418,121031412,New South Wales,5278,2363,7641
419,121041413,New South Wales,2778,2081,4859
420,121041414,New South Wales,7403,5486,12889
421,121041415,New South Wales,10320,7872,18192
422,121041416,New South Wales,4074,3890,7964
423,121041417,New South Wales,3163,2817,5980
424,122011418,New South Wales,4731,4429,9160
425,122011419,New South Wales,5071,5502,10573
426,122021420,New South Wales,3018,2577,5595
427,122021421,New South Wales,671,358,1029
428,122021422,New South Wales,2956,1979,4935
429,122021423,New South Wales,16791,9041,25832
430,122031424,New South Wales,3168,2063,5231
431,122031425,New South Wales,2006,1038,3044
432,122031426,New South Wales,4353,3948,8301
433,122031427,New South Wales,3274,2186,5460
434,122031428,New South Wales,9687,4906,14593
435,122031429,New South Wales,12926,10973,23899
436,122031430,New South Wales,3049,2919,5968
437,122031431,New South Wales,6351,3690,10041
438,122031432,New South Wales,1416,575,1991
439,123011433,New South Wales,13942,6552,20494
440,123011434,New South Wales,5211,3240,8451
441,123011435,New South Wales,6940,5403,12343
442,123021436,New South Wales,2487,4717,7204
443,123021437,New South Wales,7593,11715,19308
444,123021438,New South Wales,2889,5171,8060
445,123021440,New South Wales,6522,9625,16147
446,123021441,New South Wales,2202,3361,5563
447,123021442,New South Wales,2672,4560,7232
448,123021443,New South Wales,2412,5378,7790
449,123021444,New South Wales,3473,5416,8889
450,123031445,New South Wales,1464,893,2357
451,123031446,New South Wales,2509,1518,4027
452,123031447,New South Wales,4760,3208,7968
453,123031448,New South Wales,2485,1001,3486
454,124011449,New South Wales,783,1836,2619
455,124011450,New South Wales,4122,4894,9016
456,124011452,New South Wales,3440,7905,11345
457,124011453,New South Wales,1442,3106,4548
458,124011454,New South Wales,7016,9174,16190
459,124011455,New South Wales,671,1390,2061
460,124031457,New South Wales,3513,3407,6920
461,124031458,New South Wales,5183,3735,8918
462,124031459,New South Wales,4644,3251,7895
463,124031460,New South Wales,5504,3756,9260
464,124031461,New South Wales,3996,3377,7373
465,124031462,New South Wales,3390,3606,6996
466,124031463,New South Wales,2299,682,2981
467,124031464,New South Wales,13714,10596,24310
468,124031465,New South Wales,1696,805,2501
469,124041466,New South Wales,7311,4682,11993
470,124041467,New South Wales,5690,3938,9628
471,124041468,New South Wales,1713,745,2458
472,124051469,New South Wales,1622,1567,3189
473,124051470,New South Wales,4277,4519,8796
474,124051580,New South Wales,2085,2826,4911
475,124051581,New South Wales,1909,2577,4486
476,125011473,New South Wales,2617,2710,5327
477,125011582,New South Wales,815,2131,2946
478,125011583,New South Wales,667,1639,2306
479,125011584,New South Wales,3084,5454,8538
480,125011585,New South Wales,595,1451,2046
481,125011586,New South Wales,1940,2997,4937
482,125011587,New South Wales,1132,2173,3305
483,125021476,New South Wales,5374,3880,9254
484,125021477,New South Wales,4541,4144,8685
485,125021478,New South Wales,3787,2887,6674
486,125031479,New South Wales,2323,4908,7231
487,125031480,New South Wales,1131,2726,3857
488,125031481,New South Wales,1512,2173,3685
489,125031482,New South Wales,5173,5037,10210
490,125031483,New South Wales,2707,4913,7620
491,125031484,New South Wales,2094,2687,4781
492,125031485,New South Wales,4097,5086,9183
493,125041489,New South Wales,2555,3572,6127
494,125041490,New South Wales,2232,1446,3678
495,125041491,New South Wales,2615,2054,4669
496,125041492,New South Wales,9157,11435,20592
497,125041493,New South Wales,3809,4343,8152
498,125041494,New South Wales,3229,1693,4922
499,125041588,New South Wales,2519,3582,6101
500,125041589,New South Wales,1787,2940,4727
501,126011495,New South Wales,8825,7023,15848
502,126011496,New South Wales,5808,3689,9497
503,126021497,New South Wales,7365,5365,12730
504,126021498,New South Wales,2770,2116,4886
505,126021499,New South Wales,3637,1985,5622
506,126021500,New South Wales,2958,2862,5820
507,126021501,New South Wales,2371,1776,4147
508,126021503,New South Wales,3882,3337,7219
509,126021590,New South Wales,1857,961,2818
510,126021591,New South Wales,9887,7626,17513
511,127011504,New South Wales,1218,2664,3882
512,127011505,New South Wales,2585,1094,3679
513,127011506,New South Wales,7701,6286,13987
514,127011593,New South Wales,2266,1683,3949
515,127011594,New South Wales,1843,3379,5222
516,127011595,New South Wales,6813,7857,14670
517,127011596,New South Wales,2204,2728,4932
518,127011597,New South Wales,2330,2047,4377
519,127021509,New South Wales,1800,3461,5261
520,127021510,New South Wales,3430,3114,6544
521,127021511,New South Wales,1690,5385,7075
522,127021512,New South Wales,1645,3559,5204
523,127021513,New South Wales,1160,3729,4889
524,127021514,New South Wales,1886,2091,3977
525,127021515,New South Wales,7043,18693,25736
526,127021516,New South Wales,1341,2787,4128
527,127021517,New South Wales,683,1143,1826
528,127021518,New South Wales,953,400,1353
529,127021519,New South Wales,4626,6006,10632
530,127021520,New South Wales,1322,2531,3853
531,127021521,New South Wales,1721,2176,3897
532,127031522,New South Wales,1816,2271,4087
533,127031523,New South Wales,4224,2906,7130
534,127031524,New South Wales,6809,4480,11289
535,127031598,New South Wales,6454,11209,17663
536,127031599,New South Wales,890,1759,2649
537,127031600,New South Wales,3583,4678,8261
538,127031601,New South Wales,593,1002,1595
539,128011529,New South Wales,4518,2489,7007
540,128011530,New South Wales,20022,9266,29288
541,128011531,New South Wales,5304,1764,7068
542,128011602,New South Wales,2424,1140,3564
543,128011603,New South Wales,3040,1137,4177
544,128011604,New South Wales,8216,4121,12337
545,128011605,New South Wales,1670,484,2154
546,128011606,New South Wales,2819,887,3706
547,128021533,New South Wales,1372,1256,2628
548,128021534,New South Wales,4053,1862,5915
549,128021535,New South Wales,7214,3643,10857
550,128021536,New South Wales,5744,4590,10334
551,128021538,New South Wales,4761,3889,8650
552,128021607,New South Wales,8848,6170,15018
553,128021608,New South Wales,1753,1453,3206
554,128021609,New South Wales,703,416,1119
555,201011001,Victoria,1584,2249,3833
556,201011002,Victoria,11297,16692,27989
557,201011003,Victoria,2216,4073,6289
558,201011004,Victoria,4494,8269,12763
559,201011005,Victoria,819,1487,2306
560,201011006,Victoria,346,726,1072
561,201011007,Victoria,624,707,1331
562,201011008,Victoria,4244,6141,10385
563,201021009,Victoria,909,1431,2340
564,201021010,Victoria,1311,2012,3323
565,201021011,Victoria,1241,2625,3866
566,201021012,Victoria,881,887,1768
567,201031013,Victoria,971,669,1640
568,201031014,Victoria,815,801,1616
569,201031015,Victoria,810,992,1802
570,201031016,Victoria,2449,2631,5080
571,201031017,Victoria,844,839,1683
572,202011018,Victoria,10503,14498,25001
573,202011019,Victoria,1150,2273,3423
574,202011020,Victoria,1113,1512,2625
575,202011021,Victoria,1236,2176,3412
576,202011022,Victoria,8591,10869,19460
577,202011023,Victoria,699,766,1465
578,202011024,Victoria,1357,1284,2641
579,202011025,Victoria,1664,2297,3961
580,202021026,Victoria,1021,1212,2233
581,202021027,Victoria,1955,5432,7387
582,202021028,Victoria,1164,2173,3337
583,202021029,Victoria,997,1041,2038
584,202021030,Victoria,1577,2437,4014
585,202021031,Victoria,1091,2014,3105
586,202031032,Victoria,677,625,1302
587,202031033,Victoria,2081,1084,3165
588,203011034,Victoria,1100,1328,2428
589,203011035,Victoria,1637,1532,3169
590,203011036,Victoria,1296,1135,2431
591,203021037,Victoria,7259,7718,14977
592,203021038,Victoria,2229,6595,8824
593,203021039,Victoria,10228,14089,24317
594,203021040,Victoria,2760,4664,7424
595,203021041,Victoria,10377,12499,22876
596,203021042,Victoria,2754,2678,5432
597,203021043,Victoria,2991,4561,7552
598,203021044,Victoria,2010,2291,4301
599,203021045,Victoria,1582,3682,5264
600,203021046,Victoria,1975,2026,4001
601,203021047,Victoria,1622,2829,4451
602,203031048,Victoria,2612,3062,5674
603,203031049,Victoria,776,1107,1883
604,203031050,Victoria,3834,4675,8509
605,203031051,Victoria,1410,1517,2927
606,203031052,Victoria,4704,4203,8907
607,203031053,Victoria,6489,7890,14379
608,204011054,Victoria,1922,1257,3179
609,204011055,Victoria,1720,1118,2838
610,204011056,Victoria,5085,6093,11178
611,204011057,Victoria,3164,1640,4804
612,204011058,Victoria,1032,450,1482
613,204011059,Victoria,3998,2746,6744
614,204011060,Victoria,619,350,969
615,204011062,Victoria,942,587,1529
616,204021063,Victoria,4905,2780,7685
617,204021064,Victoria,476,219,695
618,204021065,Victoria,1082,624,1706
619,204021066,Victoria,11675,6232,17907
620,204021067,Victoria,1514,649,2163
621,204031068,Victoria,881,1059,1940
622,204031069,Victoria,2752,1948,4700
623,204031070,Victoria,833,469,1302
624,204031071,Victoria,1094,577,1671
625,204031072,Victoria,1797,798,2595
626,204031073,Victoria,1134,701,1835
627,204031074,Victoria,15029,8402,23431
628,204031075,Victoria,961,621,1582
629,205011076,Victoria,3309,2305,5614
630,205011077,Victoria,1638,929,2567
631,205011078,Victoria,1632,1184,2816
632,205011079,Victoria,12084,6888,18972
633,205021081,Victoria,10833,4023,14856
634,205021082,Victoria,1887,745,2632
635,205021084,Victoria,3806,1594,5400
636,205021085,Victoria,1705,881,2586
637,205021086,Victoria,1123,640,1763
638,205031087,Victoria,2611,1799,4410
639,205031089,Victoria,2567,1608,4175
640,205031090,Victoria,3350,1881,5231
641,205031091,Victoria,3139,3358,6497
642,205031093,Victoria,8278,7625,15903
643,205041094,Victoria,1971,1700,3671
644,205041095,Victoria,4195,5044,9239
645,205041096,Victoria,5756,5037,10793
646,205041097,Victoria,11595,6520,18115
647,205041098,Victoria,1159,705,1864
648,205051100,Victoria,798,430,1228
649,205051101,Victoria,3651,1266,4917
650,205051102,Victoria,1188,433,1621
651,205051103,Victoria,10715,3977,14692
652,205051104,Victoria,1739,626,2365
653,206011105,Victoria,1243,7515,8758
654,206011106,Victoria,591,3750,4341
655,206011107,Victoria,817,3732,4549
656,206011108,Victoria,2318,9444,11762
657,206011109,Victoria,923,1826,2749
658,206021110,Victoria,689,2621,3310
659,206021111,Victoria,1563,8147,9710
660,206021112,Victoria,7115,26048,33163
661,206031113,Victoria,1476,3779,5255
662,206031114,Victoria,16446,19994,36440
663,206031115,Victoria,335,1913,2248
664,206031116,Victoria,1853,2878,4731
665,206041117,Victoria,416,1201,1617
666,206041118,Victoria,776,847,1623
667,206041119,Victoria,670,841,1511
668,206041121,Victoria,1015,2823,3838
669,206041122,Victoria,12481,21167,33648
670,206041123,Victoria,1307,3535,4842
671,206041124,Victoria,546,1367,1913
672,206041125,Victoria,3880,5331,9211
673,206041126,Victoria,3767,4867,8634
674,206051128,Victoria,2257,2879,5136
675,206051129,Victoria,1465,3012,4477
676,206051130,Victoria,2480,3100,5580
677,206051132,Victoria,1332,2052,3384
678,206051133,Victoria,2374,6492,8866
679,206051134,Victoria,466,1309,1775
680,206061135,Victoria,2098,1322,3420
681,206061136,Victoria,2216,3666,5882
682,206061137,Victoria,7246,7928,15174
683,206061138,Victoria,2418,1260,3678
684,206071139,Victoria,4047,7723,11770
685,206071140,Victoria,924,2761,3685
686,206071141,Victoria,255,949,1204
687,206071142,Victoria,728,2748,3476
688,206071143,Victoria,1308,4876,6184
689,206071144,Victoria,3522,5678,9200
690,206071145,Victoria,870,3623,4493
691,207011146,Victoria,2040,2099,4139
692,207011147,Victoria,2521,1614,4135
693,207011148,Victoria,4982,3412,8394
694,207011149,Victoria,3413,2964,6377
695,207011150,Victoria,3398,2643,6041
696,207011151,Victoria,12079,9549,21628
697,207011152,Victoria,2496,2406,4902
698,207011153,Victoria,3725,3058,6783
699,207011154,Victoria,2239,2158,4397
700,207011155,Victoria,4256,3531,7787
701,207021156,Victoria,2014,1589,3603
702,207021157,Victoria,2953,2505,5458
703,207021159,Victoria,3112,1870,4982
704,207021160,Victoria,3007,2557,5564
705,207021424,Victoria,11210,6417,17627
706,207021425,Victoria,3574,2855,6429
707,207031161,Victoria,9855,10204,20059
708,207031162,Victoria,1538,1668,3206
709,207031163,Victoria,4077,4207,8284
710,207031164,Victoria,2553,2817,5370
711,207031165,Victoria,1287,1417,2704
712,207031166,Victoria,2275,2691,4966
713,207031167,Victoria,1426,1396,2822
714,208011168,Victoria,2787,1538,4325
715,208011169,Victoria,5637,3397,9034
716,208011170,Victoria,2099,1334,3433
717,208011171,Victoria,1848,2344,4192
718,208011172,Victoria,14237,9140,23377
719,208011173,Victoria,4169,3234,7403
720,208021174,Victoria,4005,4043,8048
721,208021176,Victoria,1713,2561,4274
722,208021177,Victoria,2598,3251,5849
723,208021178,Victoria,3560,2811,6371
724,208021179,Victoria,1066,1449,2515
725,208021180,Victoria,601,962,1563
726,208021181,Victoria,1823,2214,4037
727,208021182,Victoria,1623,2131,3754
728,208021426,Victoria,2168,2680,4848
729,208021427,Victoria,3132,3595,6727
730,208031183,Victoria,896,1368,2264
731,208031185,Victoria,1878,2309,4187
732,208031186,Victoria,1480,2749,4229
733,208031187,Victoria,844,1543,2387
734,208031188,Victoria,10187,10615,20802
735,208031189,Victoria,1765,2800,4565
736,208031190,Victoria,2533,3337,5870
737,208031191,Victoria,2032,2577,4609
738,208031193,Victoria,9531,10427,19958
739,208041194,Victoria,17557,11044,28601
740,208041195,Victoria,4273,3506,7779
741,209011196,Victoria,1029,1651,2680
742,209011197,Victoria,15018,16852,31870
743,209011198,Victoria,10629,13637,24266
744,209011199,Victoria,1053,3008,4061
745,209011200,Victoria,1444,2313,3757
746,209011201,Victoria,1067,994,2061
747,209011202,Victoria,2464,3412,5876
748,209011203,Victoria,2304,3385,5689
749,209011204,Victoria,1346,1906,3252
750,209021205,Victoria,713,1307,2020
751,209021207,Victoria,1992,6014,8006
752,209021208,Victoria,2023,5462,7485
753,209021428,Victoria,968,3828,4796
754,209021429,Victoria,1154,4616,5770
755,209031209,Victoria,2566,3719,6285
756,209031210,Victoria,1128,1438,2566
757,209031211,Victoria,849,954,1803
758,209031212,Victoria,1936,2294,4230
759,209031213,Victoria,1601,2647,4248
760,209031214,Victoria,1857,2060,3917
761,209031215,Victoria,2036,2551,4587
762,209041216,Victoria,428,474,902
763,209041217,Victoria,658,1507,2165
764,209041219,Victoria,1454,5708,7162
765,209041220,Victoria,2131,4321,6452
766,209041221,Victoria,4512,11021,15533
767,209041223,Victoria,940,3937,4877
768,209041224,Victoria,1731,2571,4302
769,209041225,Victoria,1358,1336,2694
770,209041430,Victoria,1380,1932,3312
771,209041431,Victoria,772,2205,2977
772,209041432,Victoria,649,2029,2678
773,209041433,Victoria,993,3498,4491
774,209041434,Victoria,1601,3439,5040
775,209041435,Victoria,1041,2433,3474
776,209041436,Victoria,5723,11653,17376
777,209041437,Victoria,193,541,734
778,210011226,Victoria,1061,1474,2535
779,210011228,Victoria,1749,1675,3424
780,210011229,Victoria,3557,5279,8836
781,210011230,Victoria,737,887,1624
782,210011231,Victoria,1315,1664,2979
783,210021232,Victoria,2233,2403,4636
784,210021233,Victoria,611,815,1426
785,210021234,Victoria,682,917,1599
786,210021235,Victoria,1727,1859,3586
787,210031236,Victoria,393,1336,1729
788,210031237,Victoria,1035,3288,4323
789,210031239,Victoria,2486,5833,8319
790,210031438,Victoria,5744,14525,20269
791,210031439,Victoria,475,585,1060
792,210041240,Victoria,1515,2190,3705
793,210041241,Victoria,10904,12783,23687
794,210051242,Victoria,467,2102,2569
795,210051243,Victoria,713,2858,3571
796,210051245,Victoria,6983,11611,18594
797,210051246,Victoria,1576,1961,3537
798,210051247,Victoria,527,2683,3210
799,210051249,Victoria,1292,3925,5217
800,210051250,Victoria,428,708,1136
801,210051441,Victoria,350,993,1343
802,210051442,Victoria,1017,2792,3809
803,210051443,Victoria,5565,13148,18713
804,210051444,Victoria,492,1240,1732
805,210051445,Victoria,696,1353,2049
806,211011251,Victoria,2018,1870,3888
807,211011254,Victoria,2808,1959,4767
808,211011255,Victoria,1417,653,2070
809,211011256,Victoria,11640,6071,17711
810,211011257,Victoria,1555,751,2306
811,211011258,Victoria,1667,1101,2768
812,211011259,Victoria,2793,1935,4728
813,211011260,Victoria,9385,5238,14623
814,211011446,Victoria,12406,9956,22362
815,211011447,Victoria,2611,2496,5107
816,211011448,Victoria,2602,2347,4949
817,211011449,Victoria,771,754,1525
818,211021261,Victoria,2908,1942,4850
819,211021262,Victoria,1635,1310,2945
820,211031263,Victoria,1463,1512,2975
821,211031265,Victoria,3953,2714,6667
822,211031266,Victoria,2317,2308,4625
823,211031267,Victoria,4524,4714,9238
824,211031268,Victoria,11075,7838,18913
825,211031450,Victoria,9168,6001,15169
826,211031451,Victoria,2000,2011,4011
827,211031452,Victoria,378,348,726
828,211041269,Victoria,737,779,1516
829,211041270,Victoria,3185,3552,6737
830,211041271,Victoria,781,946,1727
831,211041272,Victoria,2012,1726,3738
832,211041273,Victoria,1797,1316,3113
833,211051274,Victoria,1589,2345,3934
834,211051275,Victoria,1377,883,2260
835,211051276,Victoria,3667,3667,7334
836,211051277,Victoria,1703,1483,3186
837,211051278,Victoria,13764,8538,22302
838,211051279,Victoria,1548,1242,2790
839,211051280,Victoria,1538,1299,2837
840,211051281,Victoria,4434,3760,8194
841,211051282,Victoria,1513,2584,4097
842,211051283,Victoria,1859,1436,3295
843,211051284,Victoria,1255,2356,3611
844,211051285,Victoria,1762,978,2740
845,211051286,Victoria,3156,3065,6221
846,212011287,Victoria,2221,1895,4116
847,212011288,Victoria,2338,1197,3535
848,212011289,Victoria,3407,3161,6568
849,212011290,Victoria,1679,1126,2805
850,212011291,Victoria,1331,1457,2788
851,212011292,Victoria,13883,11618,25501
852,212021293,Victoria,17246,13609,30855
853,212021294,Victoria,3132,3192,6324
854,212021295,Victoria,682,1646,2328
855,212021297,Victoria,1001,2055,3056
856,212021299,Victoria,1613,838,2451
857,212021453,Victoria,1459,2074,3533
858,212021454,Victoria,2021,2892,4913
859,212021455,Victoria,1822,2346,4168
860,212021456,Victoria,1359,2220,3579
861,212031300,Victoria,14589,19634,34223
862,212031301,Victoria,1983,3016,4999
863,212031302,Victoria,1828,3087,4915
864,212031303,Victoria,2159,1870,4029
865,212031304,Victoria,1055,1529,2584
866,212031305,Victoria,2032,4876,6908
867,212031306,Victoria,1484,2567,4051
868,212031308,Victoria,1674,1189,2863
869,212031457,Victoria,1249,1419,2668
870,212031458,Victoria,1478,2896,4374
871,212041309,Victoria,1325,2389,3714
872,212041310,Victoria,1067,2541,3608
873,212041311,Victoria,2449,5931,8380
874,212041312,Victoria,7703,12988,20691
875,212041313,Victoria,1639,1897,3536
876,212041314,Victoria,1864,3608,5472
877,212041316,Victoria,766,1770,2536
878,212041317,Victoria,1114,2894,4008
879,212041318,Victoria,7768,15275,23043
880,212041459,Victoria,683,1778,2461
881,212041460,Victoria,829,1992,2821
882,212051319,Victoria,1625,2162,3787
883,212051320,Victoria,785,1528,2313
884,212051321,Victoria,3935,3270,7205
885,212051322,Victoria,1807,1901,3708
886,212051323,Victoria,7642,6257,13899
887,212051324,Victoria,3380,3796,7176
888,212051325,Victoria,8319,8553,16872
889,212051326,Victoria,9840,13233,23073
890,212051327,Victoria,4137,3439,7576
891,213011328,Victoria,418,916,1334
892,213011329,Victoria,730,1460,2190
893,213011330,Victoria,1324,3820,5144
894,213011331,Victoria,602,1552,2154
895,213011332,Victoria,1913,2872,4785
896,213011333,Victoria,653,1747,2400
897,213011334,Victoria,8562,17588,26150
898,213011335,Victoria,464,1195,1659
899,213011336,Victoria,4242,8802,13044
900,213011337,Victoria,690,1495,2185
901,213011338,Victoria,4863,9759,14622
902,213011339,Victoria,1521,2958,4479
903,213011340,Victoria,2977,3382,6359
904,213021341,Victoria,9374,13954,23328
905,213021342,Victoria,1478,3503,4981
906,213021343,Victoria,988,2680,3668
907,213021344,Victoria,1880,4165,6045
908,213021345,Victoria,834,1317,2151
909,213021346,Victoria,2534,4212,6746
910,213031347,Victoria,369,946,1315
911,213031348,Victoria,3569,9681,13250
912,213031349,Victoria,565,1132,1697
913,213031350,Victoria,543,2074,2617
914,213031351,Victoria,3095,8055,11150
915,213031352,Victoria,1683,5106,6789
916,213041353,Victoria,2812,4097,6909
917,213041355,Victoria,2364,4012,6376
918,213041356,Victoria,10920,17547,28467
919,213041357,Victoria,1823,3514,5337
920,213041358,Victoria,1126,2527,3653
921,213041359,Victoria,315,626,941
922,213041360,Victoria,1384,2643,4027
923,213041461,Victoria,172,412,584
924,213041462,Victoria,220,554,774
925,213041463,Victoria,2315,4657,6972
926,213051361,Victoria,2129,3774,5903
927,213051362,Victoria,10045,15571,25616
928,213051363,Victoria,247,727,974
929,213051365,Victoria,2332,4848,7180
930,213051366,Victoria,1253,2766,4019
931,213051368,Victoria,9066,12412,21478
932,213051369,Victoria,1667,3877,5544
933,213051464,Victoria,345,530,875
934,213051465,Victoria,3659,4838,8497
935,213051466,Victoria,1300,1695,2995
936,213051467,Victoria,1287,2839,4126
937,213051468,Victoria,1071,2064,3135
938,214011370,Victoria,7682,9902,17584
939,214011371,Victoria,11229,12642,23871
940,214011372,Victoria,2196,3883,6079
941,214011373,Victoria,2309,2116,4425
942,214011374,Victoria,5550,5514,11064
943,214011375,Victoria,1941,3289,5230
944,214011376,Victoria,659,903,1562
945,214021377,Victoria,1511,1424,2935
946,214021378,Victoria,1141,1197,2338
947,214021379,Victoria,9004,7752,16756
948,214021380,Victoria,14438,10176,24614
949,214021381,Victoria,3545,2391,5936
950,214021382,Victoria,2006,1787,3793
951,214021383,Victoria,2494,2435,4929
952,214021384,Victoria,10346,8649,18995
953,214021385,Victoria,3785,3023,6808
954,215011386,Victoria,2758,2534,5292
955,215011387,Victoria,622,277,899
956,215011388,Victoria,8775,3944,12719
957,215011389,Victoria,203,104,307
958,215011390,Victoria,2077,779,2856
959,215011391,Victoria,906,439,1345
960,215011392,Victoria,1935,1563,3498
961,215011393,Victoria,838,296,1134
962,215011394,Victoria,2053,721,2774
963,215021395,Victoria,7542,3779,11321
964,215021396,Victoria,790,484,1274
965,215021398,Victoria,1047,304,1351
966,215021399,Victoria,846,548,1394
967,215021469,Victoria,6845,4381,11226
968,215021470,Victoria,1717,1170,2887
969,215031400,Victoria,1930,755,2685
970,215031401,Victoria,2142,610,2752
971,215031402,Victoria,1472,504,1976
972,215031403,Victoria,682,262,944
973,215031404,Victoria,5790,1840,7630
974,215031405,Victoria,1258,367,1625
975,216011406,Victoria,10207,3656,13863
976,216011407,Victoria,3529,1007,4536
977,216011408,Victoria,913,214,1127
978,216011409,Victoria,1219,398,1617
979,216011410,Victoria,1356,431,1787
980,216021411,Victoria,2809,1053,3862
981,216021412,Victoria,404,107,511
982,216021413,Victoria,3900,1314,5214
983,216021414,Victoria,4166,1787,5953
984,216031415,Victoria,1341,683,2024
985,216031416,Victoria,15856,6329,22185
986,216031417,Victoria,4308,2193,6501
987,216031418,Victoria,1318,311,1629
988,216031419,Victoria,2862,1059,3921
989,217011420,Victoria,2006,1117,3123
990,217011421,Victoria,5179,2781,7960
991,217011422,Victoria,4346,3795,8141
992,217011423,Victoria,1629,732,2361
993,217031471,Victoria,1182,645,1827
994,217031472,Victoria,6846,3997,10843
995,217031473,Victoria,957,507,1464
996,217031474,Victoria,1694,779,2473
997,217031475,Victoria,2412,791,3203
998,217031476,Victoria,492,693,1185
999,217041477,Victoria,1494,618,2112
1000,217041478,Victoria,2216,1397,3613
1001,217041479,Victoria,2106,1663,3769
1002,217041480,Victoria,13560,8852,22412
1003,301011001,Queensland,3396,3004,6400
1004,301011002,Queensland,2467,1208,3675
1005,301011003,Queensland,2900,2180,5080
1006,301011004,Queensland,9114,6375,15489
1007,301011005,Queensland,691,525,1216
1008,301011006,Queensland,1932,1188,3120
1009,301021007,Queensland,13227,7308,20535
1010,301021008,Queensland,1324,820,2144
1011,301021009,Queensland,1843,1223,3066
1012,301021011,Queensland,1142,782,1924
1013,301021012,Queensland,1358,976,2334
1014,301021013,Queensland,10007,6319,16326
1015,301021527,Queensland,1785,1868,3653
1016,301031015,Queensland,1309,1087,2396
1017,301031016,Queensland,2651,2414,5065
1018,301031017,Queensland,625,783,1408
1019,301031018,Queensland,1774,1575,3349
1020,301031020,Queensland,9794,7937,17731
1021,301031021,Queensland,1318,1541,2859
1022,302011022,Queensland,1065,895,1960
1023,302011023,Queensland,1644,672,2316
1024,302011025,Queensland,1586,1786,3372
1025,302011026,Queensland,1955,1336,3291
1026,302021027,Queensland,3746,2891,6637
1027,302021028,Queensland,12966,9583,22549
1028,302021029,Queensland,1160,1178,2338
1029,302021030,Queensland,862,1033,1895
1030,302021031,Queensland,2366,2400,4766
1031,302021032,Queensland,1472,1682,3154
1032,302021033,Queensland,1285,1352,2637
1033,302021034,Queensland,1404,1431,2835
1034,302031035,Queensland,1335,1709,3044
1035,302031038,Queensland,3314,3478,6792
1036,302031039,Queensland,1743,2250,3993
1037,302031040,Queensland,2144,2664,4808
1038,302041041,Queensland,3333,2826,6159
1039,302041042,Queensland,1255,1622,2877
1040,302041043,Queensland,307,433,740
1041,302041044,Queensland,6081,5708,11789
1042,302041045,Queensland,1809,2333,4142
1043,302041046,Queensland,955,1511,2466
1044,303011047,Queensland,2124,2161,4285
1045,303011048,Queensland,1234,1504,2738
1046,303011049,Queensland,764,914,1678
1047,303011050,Queensland,1573,1356,2929
1048,303011051,Queensland,4113,2765,6878
1049,303021052,Queensland,1768,3303,5071
1050,303021053,Queensland,12542,11589,24131
1051,303021054,Queensland,837,1596,2433
1052,303021055,Queensland,973,1595,2568
1053,303021056,Queensland,1434,1808,3242
1054,303021057,Queensland,870,942,1812
1055,303021058,Queensland,442,918,1360
1056,303021059,Queensland,1732,2195,3927
1057,303031060,Queensland,2479,2250,4729
1058,303031061,Queensland,1126,1138,2264
1059,303031062,Queensland,10054,7457,17511
1060,303031063,Queensland,1403,1590,2993
1061,303031064,Queensland,2394,1288,3682
1062,303031065,Queensland,1305,1403,2708
1063,303031066,Queensland,1200,1025,2225
1064,303041067,Queensland,676,927,1603
1065,303041068,Queensland,1348,2568,3916
1066,303041069,Queensland,691,593,1284
1067,303041070,Queensland,871,1357,2228
1068,303041071,Queensland,1751,1789,3540
1069,303051072,Queensland,2210,2465,4675
1070,303051073,Queensland,2909,3475,6384
1071,303051074,Queensland,319,391,710
1072,303051076,Queensland,5982,6270,12252
1073,303061077,Queensland,1161,1617,2778
1074,303061078,Queensland,1664,2029,3693
1075,303061079,Queensland,1481,1527,3008
1076,303061080,Queensland,1741,1456,3197
1077,304011081,Queensland,1699,1532,3231
1078,304011082,Queensland,3059,2874,5933
1079,304011084,Queensland,5564,4035,9599
1080,304021086,Queensland,3990,2433,6423
1081,304021087,Queensland,1159,581,1740
1082,304021088,Queensland,2158,1358,3516
1083,304021089,Queensland,1248,622,1870
1084,304021090,Queensland,2493,1836,4329
1085,304021091,Queensland,818,411,1229
1086,304031092,Queensland,2276,1530,3806
1087,304031093,Queensland,1138,1110,2248
1088,304031094,Queensland,8106,6007,14113
1089,304031095,Queensland,844,934,1778
1090,304031096,Queensland,1744,1601,3345
1091,304041098,Queensland,1176,1160,2336
1092,304041100,Queensland,1922,2315,4237
1093,304041101,Queensland,1558,1764,3322
1094,304041103,Queensland,5155,4412,9567
1095,304041104,Queensland,1974,1766,3740
1096,305011105,Queensland,19422,19805,39227
1097,305011108,Queensland,859,904,1763
1098,305011109,Queensland,4402,3950,8352
1099,305011110,Queensland,702,1240,1942
1100,305011111,Queensland,1087,1429,2516
1101,305011112,Queensland,2847,5321,8168
1102,305021113,Queensland,724,614,1338
1103,305021114,Queensland,2020,1581,3601
1104,305021115,Queensland,955,1126,2081
1105,305021117,Queensland,2435,2773,5208
1106,305021118,Queensland,1564,1534,3098
1107,305031121,Queensland,2003,763,2766
1108,305031122,Queensland,2622,1606,4228
1109,305031123,Queensland,2262,1642,3904
1110,305031124,Queensland,2084,1181,3265
1111,305031125,Queensland,1503,562,2065
1112,305031126,Queensland,879,1395,2274
1113,305031127,Queensland,1561,1773,3334
1114,305031130,Queensland,1264,1539,2803
1115,305031131,Queensland,1771,1601,3372
1116,305041132,Queensland,3185,2743,5928
1117,305041133,Queensland,931,992,1923
1118,305041134,Queensland,1723,1578,3301
1119,305041135,Queensland,2466,2596,5062
1120,305041136,Queensland,1457,1536,2993
1121,305041137,Queensland,1877,2128,4005
1122,306011138,Queensland,529,426,955
1123,306011139,Queensland,1590,1122,2712
1124,306011140,Queensland,1012,877,1889
1125,306011141,Queensland,1998,1470,3468
1126,306011142,Queensland,4757,3604,8361
1127,306011143,Queensland,1015,1179,2194
1128,306021144,Queensland,5248,3961,9209
1129,306021145,Queensland,6938,5797,12735
1130,306021146,Queensland,949,708,1657
1131,306021147,Queensland,967,944,1911
1132,306021148,Queensland,1139,902,2041
1133,306021149,Queensland,633,604,1237
1134,306021152,Queensland,985,1240,2225
1135,306021154,Queensland,10004,7090,17094
1136,306021155,Queensland,762,716,1478
1137,306021156,Queensland,1726,1813,3539
1138,306021157,Queensland,1374,1163,2537
1139,306031158,Queensland,1163,617,1780
1140,306031159,Queensland,3804,2437,6241
1141,306031160,Queensland,1671,851,2522
1142,306031161,Queensland,3735,1977,5712
1143,306031163,Queensland,153,558,711
1144,306041164,Queensland,1294,1015,2309
1145,306041165,Queensland,1896,1240,3136
1146,306051166,Queensland,5873,2871,8744
1147,306051167,Queensland,1061,746,1807
1148,306051168,Queensland,503,774,1277
1149,306051169,Queensland,1694,989,2683
1150,306051170,Queensland,4679,2249,6928
1151,307011171,Queensland,1354,490,1844
1152,307011172,Queensland,2738,815,3553
1153,307011173,Queensland,2842,661,3503
1154,307011174,Queensland,1032,340,1372
1155,307011175,Queensland,1251,267,1518
1156,307011176,Queensland,2928,917,3845
1157,307011177,Queensland,1107,245,1352
1158,307011178,Queensland,855,312,1167
1159,307021179,Queensland,2402,745,3147
1160,307021180,Queensland,2082,743,2825
1161,307021181,Queensland,936,321,1257
1162,307021182,Queensland,1742,540,2282
1163,307021183,Queensland,6854,1847,8701
1164,307031184,Queensland,1409,366,1775
1165,307031185,Queensland,931,244,1175
1166,307031186,Queensland,1284,407,1691
1167,307031187,Queensland,2780,1228,4008
1168,307031188,Queensland,1314,606,1920
1169,307031189,Queensland,7692,2950,10642
1170,308011190,Queensland,1209,1167,2376
1171,308011191,Queensland,1295,484,1779
1172,308011192,Queensland,5138,2134,7272
1173,308031205,Queensland,684,722,1406
1174,308031206,Queensland,357,211,568
1175,308031207,Queensland,914,640,1554
1176,308031208,Queensland,1758,1376,3134
1177,308031209,Queensland,489,205,694
1178,308031210,Queensland,2451,2310,4761
1179,308031211,Queensland,1171,1002,2173
1180,308031212,Queensland,474,674,1148
1181,308031213,Queensland,1435,964,2399
1182,308031214,Queensland,524,545,1069
1183,308031215,Queensland,1657,1253,2910
1184,308031216,Queensland,1153,1010,2163
1185,308031217,Queensland,11376,7483,18859
1186,308031218,Queensland,493,300,793
1187,308031219,Queensland,301,170,471
1188,308031220,Queensland,676,181,857
1189,308031222,Queensland,1277,889,2166
1190,308031223,Queensland,8659,4535,13194
1191,308041528,Queensland,1962,612,2574
1192,308041529,Queensland,2118,1553,3671
1193,308051530,Queensland,1586,1106,2692
1194,308051531,Queensland,1883,2008,3891
1195,308051533,Queensland,964,1327,2291
1196,308051534,Queensland,7656,9242,16898
1197,308051535,Queensland,1479,1226,2705
1198,308051538,Queensland,332,540,872
1199,308051539,Queensland,688,992,1680
1200,309011224,Queensland,791,298,1089
1201,309011225,Queensland,9245,5127,14372
1202,309011226,Queensland,1209,822,2031
1203,309011227,Queensland,1941,1115,3056
1204,309011228,Queensland,10242,4329,14571
1205,309011229,Queensland,689,471,1160
1206,309021230,Queensland,1029,942,1971
1207,309021231,Queensland,2207,1763,3970
1208,309021232,Queensland,1119,809,1928
1209,309021233,Queensland,1872,1392,3264
1210,309021234,Queensland,7814,5252,13066
1211,309031235,Queensland,2676,1917,4593
1212,309031236,Queensland,1264,853,2117
1213,309031237,Queensland,2720,1709,4429
1214,309031238,Queensland,2174,2055,4229
1215,309031240,Queensland,13647,5000,18647
1216,309041241,Queensland,104,158,262
1217,309041242,Queensland,3741,2453,6194
1218,309051243,Queensland,1505,980,2485
1219,309051244,Queensland,3621,1850,5471
1220,309051245,Queensland,1742,857,2599
1221,309061246,Queensland,6912,3322,10234
1222,309061247,Queensland,1668,1169,2837
1223,309061248,Queensland,4363,3061,7424
1224,309061249,Queensland,2765,2152,4917
1225,309061250,Queensland,456,249,705
1226,309071251,Queensland,2727,1838,4565
1227,309071252,Queensland,14391,7681,22072
1228,309071253,Queensland,2159,670,2829
1229,309071254,Queensland,1326,544,1870
1230,309071255,Queensland,3215,1897,5112
1231,309071256,Queensland,2499,1621,4120
1232,309071257,Queensland,2992,2287,5279
1233,309071258,Queensland,4275,2889,7164
1234,309081260,Queensland,1677,863,2540
1235,309081261,Queensland,15881,7823,23704
1236,309081262,Queensland,2740,2259,4999
1237,309091263,Queensland,3393,2078,5471
1238,309091540,Queensland,12133,7155,19288
1239,309091541,Queensland,1373,1065,2438
1240,309101267,Queensland,1897,825,2722
1241,309101269,Queensland,1135,381,1516
1242,309101270,Queensland,4729,2131,6860
1243,310011271,Queensland,421,1010,1431
1244,310011272,Queensland,889,2678,3567
1245,310011273,Queensland,6774,10951,17725
1246,310011274,Queensland,526,1871,2397
1247,310011275,Queensland,1216,1758,2974
1248,310011276,Queensland,208,557,765
1249,310021277,Queensland,3926,1399,5325
1250,310021278,Queensland,1295,767,2062
1251,310021280,Queensland,3823,2476,6299
1252,310021281,Queensland,3107,2704,5811
1253,310021282,Queensland,2400,2007,4407
1254,310031283,Queensland,1846,2233,4079
1255,310031284,Queensland,1183,1877,3060
1256,310031285,Queensland,5259,4753,10012
1257,310031286,Queensland,7200,7946,15146
1258,310031287,Queensland,2194,3173,5367
1259,310031288,Queensland,381,202,583
1260,310031289,Queensland,1491,947,2438
1261,310031290,Queensland,1257,1028,2285
1262,310031291,Queensland,787,1353,2140
1263,310031292,Queensland,1808,2111,3919
1264,310031293,Queensland,1682,2072,3754
1265,310031294,Queensland,1233,1177,2410
1266,310031295,Queensland,305,576,881
1267,310041296,Queensland,2538,3034,5572
1268,310041297,Queensland,1552,2083,3635
1269,310041299,Queensland,1326,2023,3349
1270,310041300,Queensland,782,1687,2469
1271,310041302,Queensland,1529,2545,4074
1272,310041303,Queensland,817,1101,1918
1273,310041304,Queensland,5844,6587,12431
1274,311011305,Queensland,5109,2389,7498
1275,311021306,Queensland,8403,5691,14094
1276,311021307,Queensland,1193,1353,2546
1277,311021308,Queensland,1017,980,1997
1278,311021309,Queensland,1409,1149,2558
1279,311021310,Queensland,1144,728,1872
1280,311031311,Queensland,2404,2106,4510
1281,311031312,Queensland,599,1053,1652
1282,311031313,Queensland,869,641,1510
1283,311031314,Queensland,693,1444,2137
1284,311031316,Queensland,735,701,1436
1285,311031317,Queensland,673,1460,2133
1286,311031319,Queensland,7920,7881,15801
1287,311041320,Queensland,2289,1626,3915
1288,311041321,Queensland,7792,5636,13428
1289,311041322,Queensland,1453,1044,2497
1290,311051323,Queensland,1558,1458,3016
1291,311051324,Queensland,1637,858,2495
1292,311051325,Queensland,5321,3427,8748
1293,311051326,Queensland,673,897,1570
1294,311051327,Queensland,2588,1965,4553
1295,311051328,Queensland,1656,2094,3750
1296,311061329,Queensland,1354,1157,2511
1297,311061330,Queensland,371,933,1304
1298,311061331,Queensland,5763,10045,15808
1299,311061332,Queensland,1755,1850,3605
1300,311061333,Queensland,423,755,1178
1301,311061334,Queensland,5438,4639,10077
1302,311061336,Queensland,477,1309,1786
1303,312011337,Queensland,3073,1624,4697
1304,312011338,Queensland,981,637,1618
1305,312011339,Queensland,1077,293,1370
1306,312011340,Queensland,487,427,914
1307,312011341,Queensland,1665,1882,3547
1308,312021342,Queensland,2471,1736,4207
1309,312021343,Queensland,892,616,1508
1310,312021344,Queensland,1399,830,2229
1311,312021346,Queensland,16995,9111,26106
1312,312021348,Queensland,1882,942,2824
1313,312021349,Queensland,1461,980,2441
1314,312021350,Queensland,814,429,1243
1315,312021351,Queensland,1783,874,2657
1316,312021352,Queensland,3498,1957,5455
1317,312021353,Queensland,1583,666,2249
1318,312021354,Queensland,1111,687,1798
1319,312021355,Queensland,581,471,1052
1320,312021356,Queensland,839,516,1355
1321,312021357,Queensland,1833,744,2577
1322,312021358,Queensland,825,501,1326
1323,312031359,Queensland,1962,1326,3288
1324,312031361,Queensland,4106,2144,6250
1325,313011362,Queensland,2736,2287,5023
1326,313011363,Queensland,8039,5253,13292
1327,313021365,Queensland,7849,8296,16145
1328,313021366,Queensland,8146,7310,15456
1329,313021367,Queensland,764,532,1296
1330,313021368,Queensland,1606,2171,3777
1331,313021369,Queensland,833,534,1367
1332,313031370,Queensland,1198,632,1830
1333,313031371,Queensland,1310,871,2181
1334,313041372,Queensland,6251,5192,11443
1335,313041373,Queensland,5953,4925,10878
1336,313041375,Queensland,1738,1521,3259
1337,313041376,Queensland,269,192,461
1338,313051377,Queensland,1220,994,2214
1339,313051378,Queensland,2211,1941,4152
1340,313051379,Queensland,1482,1179,2661
1341,313051380,Queensland,10832,7223,18055
1342,313051542,Queensland,2046,1331,3377
1343,314011382,Queensland,8619,5543,14162
1344,314011383,Queensland,1581,1117,2698
1345,314011384,Queensland,1823,1423,3246
1346,314011385,Queensland,1109,822,1931
1347,314011386,Queensland,7311,6834,14145
1348,314011387,Queensland,3867,2914,6781
1349,314021388,Queensland,6035,6546,12581
1350,314021389,Queensland,2608,2339,4947
1351,314021390,Queensland,10199,6971,17170
1352,314031391,Queensland,3385,3370,6755
1353,314031392,Queensland,660,890,1550
1354,314031393,Queensland,1466,1583,3049
1355,314031394,Queensland,8523,7489,16012
1356,315011395,Queensland,105,403,508
1357,315011396,Queensland,1201,1194,2395
1358,315011397,Queensland,194,62,256
1359,315011398,Queensland,237,455,692
1360,315011399,Queensland,150,308,458
1361,315011400,Queensland,897,579,1476
1362,315011401,Queensland,457,878,1335
1363,315011403,Queensland,997,679,1676
1364,315021404,Queensland,575,547,1122
1365,315021405,Queensland,4563,3065,7628
1366,315021406,Queensland,780,327,1107
1367,315021407,Queensland,722,291,1013
1368,315031408,Queensland,1359,624,1983
1369,315031409,Queensland,1347,498,1845
1370,315031410,Queensland,457,165,622
1371,315031411,Queensland,590,291,881
1372,315031412,Queensland,1232,397,1629
1373,316011413,Queensland,2092,989,3081
1374,316011414,Queensland,7620,3374,10994
1375,316011415,Queensland,2064,1189,3253
1376,316011416,Queensland,2037,1507,3544
1377,316021417,Queensland,1630,1109,2739
1378,316021418,Queensland,1276,753,2029
1379,316021419,Queensland,12964,6906,19870
1380,316021420,Queensland,3154,2223,5377
1381,316021421,Queensland,2294,1139,3433
1382,316021422,Queensland,1347,1136,2483
1383,316021423,Queensland,8137,4174,12311
1384,316021424,Queensland,7,3,10
1385,316031425,Queensland,6482,4775,11257
1386,316031426,Queensland,1883,1213,3096
1387,316031427,Queensland,18428,9211,27639
1388,316031428,Queensland,1330,934,2264
1389,316051435,Queensland,3319,1777,5096
1390,316051437,Queensland,8825,4918,13743
1391,316051438,Queensland,1772,1298,3070
1392,316051543,Queensland,567,579,1146
1393,316051544,Queensland,1143,657,1800
1394,316061439,Queensland,3838,2420,6258
1395,316061440,Queensland,2727,2346,5073
1396,316061441,Queensland,1139,808,1947
1397,316061442,Queensland,2130,1628,3758
1398,316061443,Queensland,1275,828,2103
1399,316061444,Queensland,1800,1294,3094
1400,316071545,Queensland,1610,910,2520
1401,316071546,Queensland,725,352,1077
1402,316071547,Queensland,2124,1687,3811
1403,316071548,Queensland,9827,6154,15981
1404,316081549,Queensland,3314,2950,6264
1405,317011445,Queensland,1361,465,1826
1406,317011446,Queensland,1704,994,2698
1407,317011447,Queensland,2707,1487,4194
1408,317011448,Queensland,5267,2264,7531
1409,317011449,Queensland,2382,846,3228
1410,317011450,Queensland,3198,1064,4262
1411,317011451,Queensland,2482,984,3466
1412,317011452,Queensland,1487,621,2108
1413,317011453,Queensland,1721,1252,2973
1414,317011454,Queensland,1284,822,2106
1415,317011455,Queensland,6180,2492,8672
1416,317011456,Queensland,17768,7897,25665
1417,317011457,Queensland,1842,884,2726
1418,317011458,Queensland,2790,1100,3890
1419,317011459,Queensland,3500,1944,5444
1420,318011460,Queensland,4915,1837,6752
1421,318011461,Queensland,1632,570,2202
1422,318011462,Queensland,3485,1616,5101
1423,318011463,Queensland,148,48,196
1424,318011464,Queensland,3345,1233,4578
1425,318011465,Queensland,1386,537,1923
1426,318011466,Queensland,153,341,494
1427,318021467,Queensland,728,717,1445
1428,318021468,Queensland,2146,1285,3431
1429,318021469,Queensland,658,497,1155
1430,318021470,Queensland,1852,1089,2941
1431,318021471,Queensland,2970,2535,5505
1432,318021472,Queensland,860,677,1537
1433,318021473,Queensland,3740,2332,6072
1434,318021474,Queensland,1203,985,2188
1435,318021475,Queensland,16931,9589,26520
1436,318021476,Queensland,1253,1264,2517
1437,318021477,Queensland,1094,1023,2117
1438,318021478,Queensland,451,397,848
1439,318021479,Queensland,1253,1187,2440
1440,318021480,Queensland,1140,955,2095
1441,318021481,Queensland,1549,1176,2725
1442,318021482,Queensland,2992,2028,5020
1443,318021483,Queensland,582,646,1228
1444,318021484,Queensland,1385,840,2225
1445,318021485,Queensland,939,953,1892
1446,318021486,Queensland,1215,699,1914
1447,318021487,Queensland,992,592,1584
1448,318021488,Queensland,1091,964,2055
1449,318021489,Queensland,842,450,1292
1450,318021490,Queensland,5447,3786,9233
1451,318021491,Queensland,1225,878,2103
1452,319011492,Queensland,549,385,934
1453,319011493,Queensland,3745,2091,5836
1454,319011494,Queensland,533,268,801
1455,319011495,Queensland,14559,8675,23234
1456,319011496,Queensland,1022,616,1638
1457,319011497,Queensland,1477,929,2406
1458,319011498,Queensland,1303,978,2281
1459,319011499,Queensland,2847,1240,4087
1460,319011500,Queensland,2829,1667,4496
1461,319011501,Queensland,552,518,1070
1462,319011502,Queensland,1045,851,1896
1463,319021503,Queensland,1844,798,2642
1464,319021504,Queensland,934,738,1672
1465,319021505,Queensland,5286,1927,7213
1466,319021506,Queensland,2346,1046,3392
1467,319021507,Queensland,636,193,829
1468,319021508,Queensland,974,298,1272
1469,319021509,Queensland,2632,1580,4212
1470,319031511,Queensland,1602,953,2555
1471,319031512,Queensland,10114,5049,15163
1472,319031513,Queensland,1944,934,2878
1473,319031514,Queensland,3233,1663,4896
1474,319031515,Queensland,1146,388,1534
1475,319041516,Queensland,417,205,622
1476,319041518,Queensland,13443,6516,19959
1477,319041520,Queensland,1695,1081,2776
1478,319041521,Queensland,5810,3107,8917
1479,319051522,Queensland,1984,1095,3079
1480,319051523,Queensland,509,461,970
1481,319051524,Queensland,9640,6482,16122
1482,319051525,Queensland,1420,828,2248
1483,319051526,Queensland,877,505,1382
1484,401011001,South Australia,5672,8297,13969
1485,401011002,South Australia,1655,1491,3146
1486,401021003,South Australia,2062,1499,3561
1487,401021004,South Australia,5348,5813,11161
1488,401021005,South Australia,1290,914,2204
1489,401021006,South Australia,2726,1956,4682
1490,401021007,South Australia,7731,7160,14891
1491,401021008,South Australia,1310,1329,2639
1492,401021009,South Australia,879,1085,1964
1493,401021010,South Australia,887,1002,1889
1494,401031011,South Australia,5294,3278,8572
1495,401031012,South Australia,2700,1617,4317
1496,401031013,South Australia,3084,1746,4830
1497,401041014,South Australia,3057,2415,5472
1498,401041015,South Australia,2830,2626,5456
1499,401041016,South Australia,4072,3546,7618
1500,401051017,South Australia,2747,2668,5415
1501,401051018,South Australia,10083,6967,17050
1502,401051019,South Australia,2448,2274,4722
1503,401061020,South Australia,1897,2106,4003
1504,401061021,South Australia,2940,3813,6753
1505,401061022,South Australia,2417,1831,4248
1506,401071023,South Australia,3632,4440,8072
1507,401071024,South Australia,6841,5115,11956
1508,402011025,South Australia,1590,1599,3189
1509,402011026,South Australia,6554,7108,13662
1510,402011027,South Australia,1054,923,1977
1511,402021028,South Australia,2571,4916,7487
1512,402021029,South Australia,1638,4208,5846
1513,402021030,South Australia,4165,8372,12537
1514,402021031,South Australia,1331,3151,4482
1515,402021032,South Australia,1689,2440,4129
1516,402021033,South Australia,565,399,964
1517,402021034,South Australia,2816,6850,9666
1518,402021035,South Australia,717,741,1458
1519,402031036,South Australia,2013,4075,6088
1520,402031037,South Australia,2648,3581,6229
1521,402031038,South Australia,3346,3947,7293
1522,402041040,South Australia,2540,4700,7240
1523,402041041,South Australia,1490,3018,4508
1524,402041043,South Australia,2200,5048,7248
1525,402041044,South Australia,1975,4551,6526
1526,402041046,South Australia,1792,4082,5874
1527,402041047,South Australia,3114,5048,8162
1528,402041048,South Australia,1789,4425,6214
1529,402041171,South Australia,3748,5387,9135
1530,402041172,South Australia,888,2246,3134
1531,402051049,South Australia,3717,4309,8026
1532,402051050,South Australia,1762,2258,4020
1533,402051051,South Australia,2552,1910,4462
1534,402051052,South Australia,7795,9764,17559
1535,402051053,South Australia,3701,5404,9105
1536,402051054,South Australia,2913,3968,6881
1537,402051055,South Australia,2896,3580,6476
1538,403011056,South Australia,7581,6455,14036
1539,403011057,South Australia,8178,5776,13954
1540,403021058,South Australia,2134,2844,4978
1541,403021059,South Australia,2360,3274,5634
1542,403021060,South Australia,2279,2360,4639
1543,403021061,South Australia,2155,2922,5077
1544,403021062,South Australia,2670,2891,5561
1545,403021063,South Australia,1829,2953,4782
1546,403021064,South Australia,1956,2221,4177
1547,403031065,South Australia,1242,1786,3028
1548,403031066,South Australia,1083,1428,2511
1549,403031067,South Australia,2645,2773,5418
1550,403031068,South Australia,7190,6960,14150
1551,403031069,South Australia,4332,3507,7839
1552,403031070,South Australia,1406,1495,2901
1553,403041071,South Australia,4379,4892,9271
1554,403041072,South Australia,3294,4695,7989
1555,403041073,South Australia,1049,2922,3971
1556,403041074,South Australia,1340,3023,4363
1557,403041075,South Australia,834,690,1524
1558,403041076,South Australia,1242,1305,2547
1559,403041077,South Australia,1562,1616,3178
1560,403041078,South Australia,842,1584,2426
1561,403041079,South Australia,726,2103,2829
1562,403041080,South Australia,1898,2439,4337
1563,403041083,South Australia,1514,1272,2786
1564,403041084,South Australia,1643,3526,5169
1565,403041085,South Australia,5487,9434,14921
1566,403041086,South Australia,1989,3678,5667
1567,403041087,South Australia,3199,6846,10045
1568,403041088,South Australia,775,985,1760
1569,403041089,South Australia,3038,4822,7860
1570,404011090,South Australia,763,1261,2024
1571,404011091,South Australia,3538,4468,8006
1572,404011092,South Australia,2913,2881,5794
1573,404011093,South Australia,2628,5715,8343
1574,404011094,South Australia,1376,2270,3646
1575,404011095,South Australia,3504,3976,7480
1576,404011096,South Australia,7680,7749,15429
1577,404011097,South Australia,2477,4907,7384
1578,404021099,South Australia,2397,5100,7497
1579,404021100,South Australia,1001,2013,3014
1580,404021101,South Australia,3560,6917,10477
1581,404021102,South Australia,2077,5136,7213
1582,404031105,South Australia,497,429,926
1583,404031106,South Australia,2649,2904,5553
1584,404031107,South Australia,3302,4017,7319
1585,404031108,South Australia,2447,5683,8130
1586,404031109,South Australia,1116,889,2005
1587,405011110,South Australia,1957,1195,3152
1588,405011111,South Australia,2456,1667,4123
1589,405011112,South Australia,1633,1276,2909
1590,405011113,South Australia,690,434,1124
1591,405011114,South Australia,3668,1880,5548
1592,405011115,South Australia,1294,649,1943
1593,405021116,South Australia,1479,639,2118
1594,405021117,South Australia,1562,720,2282
1595,405021118,South Australia,1396,585,1981
1596,405021119,South Australia,3208,1358,4566
1597,405031120,South Australia,1657,541,2198
1598,405031121,South Australia,3290,1856,5146
1599,405031122,South Australia,4642,4077,8719
1600,405031123,South Australia,920,387,1307
1601,405041124,South Australia,2924,1493,4417
1602,405041125,South Australia,1409,770,2179
1603,405041126,South Australia,989,736,1725
1604,405041127,South Australia,2702,977,3679
1605,405041128,South Australia,1517,669,2186
1606,406011129,South Australia,842,373,1215
1607,406011130,South Australia,2458,652,3110
1608,406011131,South Australia,1525,301,1826
1609,406011132,South Australia,903,259,1162
1610,406011133,South Australia,6156,2842,8998
1611,406011134,South Australia,897,241,1138
1612,406011136,South Australia,4934,6392,11326
1613,406021139,South Australia,304,286,590
1614,406021140,South Australia,505,228,733
1615,406021141,South Australia,150,134,284
1616,406021142,South Australia,4185,3496,7681
1617,406021143,South Australia,1065,439,1504
1618,407011144,South Australia,2378,2143,4521
1619,407011145,South Australia,1396,836,2232
1620,407011146,South Australia,2850,2098,4948
1621,407011147,South Australia,1580,1036,2616
1622,407011148,South Australia,7374,5875,13249
1623,407011149,South Australia,1419,1237,2656
1624,407021150,South Australia,1106,367,1473
1625,407021151,South Australia,1530,379,1909
1626,407021152,South Australia,1509,1000,2509
1627,407021154,South Australia,3095,873,3968
1628,407021155,South Australia,400,55,455
1629,407021156,South Australia,1269,476,1745
1630,407021157,South Australia,2643,599,3242
1631,407021158,South Australia,1249,425,1674
1632,407021173,South Australia,9346,4240,13586
1633,407021174,South Australia,3620,1897,5517
1634,407031159,South Australia,2280,903,3183
1635,407031160,South Australia,1125,691,1816
1636,407031161,South Australia,980,210,1190
1637,407031162,South Australia,2296,711,3007
1638,407031163,South Australia,196,73,269
1639,407031164,South Australia,1900,1068,2968
1640,407031165,South Australia,7294,3919,11213
1641,407031166,South Australia,601,201,802
1642,407031167,South Australia,2862,1233,4095
1643,407031168,South Australia,1230,493,1723
1644,407031169,South Australia,1742,572,2314
1645,407031170,South Australia,2200,910,3110
1646,501011001,Western Australia,1830,1248,3078
1647,501011002,Western Australia,10307,4408,14715
1648,501011003,Western Australia,3454,1653,5107
1649,501011004,Western Australia,2076,1976,4052
1650,501021005,Western Australia,4684,2574,7258
1651,501021007,Western Australia,1572,821,2393
1652,501021008,Western Australia,1328,1076,2404
1653,501021009,Western Australia,1896,2754,4650
1654,501021010,Western Australia,1167,424,1591
1655,501021012,Western Australia,2413,1428,3841
1656,501021014,Western Australia,2482,1172,3654
1657,501021015,Western Australia,1847,1235,3082
1658,501021016,Western Australia,1073,588,1661
1659,501021251,Western Australia,1778,1133,2911
1660,501021252,Western Australia,836,397,1233
1661,501021253,Western Australia,10477,5854,16331
1662,501021254,Western Australia,626,588,1214
1663,501031017,Western Australia,1666,946,2612
1664,501031018,Western Australia,1763,891,2654
1665,501031019,Western Australia,2494,1268,3762
1666,501031020,Western Australia,1132,692,1824
1667,502011021,Western Australia,1114,692,1806
1668,502011022,Western Australia,5526,3120,8646
1669,502011023,Western Australia,12555,7983,20538
1670,502011024,Western Australia,3216,1966,5182
1671,502011025,Western Australia,1091,1044,2135
1672,502011026,Western Australia,1592,923,2515
1673,502011027,Western Australia,3074,2031,5105
1674,502011028,Western Australia,1329,953,2282
1675,502011029,Western Australia,1730,1119,2849
1676,503011030,Western Australia,2247,701,2948
1677,503011031,Western Australia,3338,1462,4800
1678,503011032,Western Australia,2772,1201,3973
1679,503011033,Western Australia,2046,892,2938
1680,503011034,Western Australia,2746,1380,4126
1681,503011035,Western Australia,4464,2183,6647
1682,503011036,Western Australia,1875,954,2829
1683,503021038,Western Australia,2479,3157,5636
1684,503021039,Western Australia,2960,3815,6775
1685,503021040,Western Australia,1492,2398,3890
1686,503021041,Western Australia,8595,8879,17474
1687,503021042,Western Australia,8363,5117,13480
1688,503021043,Western Australia,4742,3350,8092
1689,504011044,Western Australia,2670,4042,6712
1690,504011045,Western Australia,2697,4306,7003
1691,504011046,Western Australia,1892,3028,4920
1692,504011047,Western Australia,9322,9092,18414
1693,504011048,Western Australia,2082,1953,4035
1694,504021049,Western Australia,653,443,1096
1695,504021050,Western Australia,1335,1328,2663
1696,504021051,Western Australia,1115,724,1839
1697,504021053,Western Australia,4584,3215,7799
1698,504021054,Western Australia,7175,5829,13004
1699,504031056,Western Australia,3402,4196,7598
1700,504031057,Western Australia,3602,5142,8744
1701,504031058,Western Australia,1324,772,2096
1702,504031059,Western Australia,9360,8030,17390
1703,504031060,Western Australia,715,336,1051
1704,504031061,Western Australia,813,618,1431
1705,504031062,Western Australia,869,1533,2402
1706,504031063,Western Australia,2316,2416,4732
1707,504031065,Western Australia,1181,1080,2261
1708,504031066,Western Australia,1744,1920,3664
1709,504031067,Western Australia,1255,1346,2601
1710,504031068,Western Australia,1432,907,2339
1711,505011070,Western Australia,1805,1984,3789
1712,505011071,Western Australia,2931,2144,5075
1713,505011072,Western Australia,4605,2776,7381
1714,505011073,Western Australia,3193,2923,6116
1715,505011074,Western Australia,2741,2228,4969
1716,505011075,Western Australia,3565,1615,5180
1717,505011076,Western Australia,2100,959,3059
1718,505011077,Western Australia,10722,6922,17644
1719,505011078,Western Australia,3449,2196,5645
1720,505011079,Western Australia,2923,1790,4713
1721,505011080,Western Australia,2877,1536,4413
1722,505011081,Western Australia,2199,1764,3963
1723,505011082,Western Australia,3537,1460,4997
1724,505011083,Western Australia,2673,1740,4413
1725,505021084,Western Australia,10821,7277,18098
1726,505021085,Western Australia,2011,3563,5574
1727,505021086,Western Australia,5701,4650,10351
1728,505021088,Western Australia,3283,2642,5925
1729,505021089,Western Australia,6794,4038,10832
1730,505021090,Western Australia,1649,2323,3972
1731,505021092,Western Australia,1754,1444,3198
1732,505021093,Western Australia,1697,1274,2971
1733,505021094,Western Australia,2103,1169,3272
1734,505021095,Western Australia,2449,2582,5031
1735,505021096,Western Australia,4763,2499,7262
1736,505021097,Western Australia,4015,3110,7125
1737,505031098,Western Australia,1703,2383,4086
1738,505031099,Western Australia,4475,4289,8764
1739,505031100,Western Australia,2723,2606,5329
1740,505031101,Western Australia,1982,2106,4088
1741,505031102,Western Australia,884,1648,2532
1742,505031103,Western Australia,6007,4741,10748
1743,505031104,Western Australia,2173,3220,5393
1744,505031105,Western Australia,4022,2608,6630
1745,505031107,Western Australia,1725,1553,3278
1746,505031108,Western Australia,7598,5956,13554
1747,505031255,Western Australia,1156,1174,2330
1748,505031257,Western Australia,509,429,938
1749,505031258,Western Australia,3140,2278,5418
1750,506011110,Western Australia,6316,8521,14837
1751,506011112,Western Australia,955,1594,2549
1752,506011113,Western Australia,3431,3660,7091
1753,506011114,Western Australia,1579,2263,3842
1754,506011115,Western Australia,1486,1075,2561
1755,506011116,Western Australia,1813,1241,3054
1756,506011117,Western Australia,761,1189,1950
1757,506021118,Western Australia,5165,5341,10506
1758,506021119,Western Australia,2970,4112,7082
1759,506021121,Western Australia,0,0,0
1760,506021122,Western Australia,3027,3359,6386
1761,506021123,Western Australia,1914,2035,3949
1762,506031124,Western Australia,2523,2653,5176
1763,506031125,Western Australia,2798,2061,4859
1764,506031127,Western Australia,9704,9538,19242
1765,506031128,Western Australia,2333,2384,4717
1766,506031129,Western Australia,3061,1819,4880
1767,506031131,Western Australia,4554,3477,8031
1768,506041132,Western Australia,2208,3053,5261
1769,506041133,Western Australia,3323,3355,6678
1770,506041134,Western Australia,2539,4059,6598
1771,506041135,Western Australia,2723,3354,6077
1772,506041136,Western Australia,1378,2023,3401
1773,506041137,Western Australia,3646,4826,8472
1774,506051138,Western Australia,3830,3332,7162
1775,506051139,Western Australia,2346,2099,4445
1776,506051140,Western Australia,4108,2417,6525
1777,506051141,Western Australia,3558,2088,5646
1778,506061142,Western Australia,5747,3750,9497
1779,506061143,Western Australia,1256,660,1916
1780,506061144,Western Australia,986,535,1521
1781,506071145,Western Australia,4072,2613,6685
1782,506071146,Western Australia,1611,1130,2741
1783,506071147,Western Australia,4316,2683,6999
1784,507011148,Western Australia,3121,3250,6371
1785,507011152,Western Australia,2171,1986,4157
1786,507011153,Western Australia,688,1370,2058
1787,507011154,Western Australia,1408,2584,3992
1788,507011159,Western Australia,2135,2714,4849
1789,507011160,Western Australia,1440,2268,3708
1790,507011161,Western Australia,7566,8092,15658
1791,507011163,Western Australia,777,1279,2056
1792,507011259,Western Australia,1798,2164,3962
1793,507021164,Western Australia,804,573,1377
1794,507021165,Western Australia,5446,9400,14846
1795,507021166,Western Australia,2245,4831,7076
1796,507031169,Western Australia,1494,2480,3974
1797,507031170,Western Australia,1400,3111,4511
1798,507031173,Western Australia,218,336,554
1799,507031174,Western Australia,513,1118,1631
1800,507031261,Western Australia,1237,1201,2438
1801,507041175,Western Australia,9067,3897,12964
1802,507041176,Western Australia,1270,750,2020
1803,507041177,Western Australia,2985,2990,5975
1804,507041178,Western Australia,3610,2242,5852
1805,507041179,Western Australia,1933,1263,3196
1806,507041180,Western Australia,3270,1985,5255
1807,507041181,Western Australia,4144,2564,6708
1808,507041182,Western Australia,1741,1706,3447
1809,507041183,Western Australia,1260,1417,2677
1810,507041184,Western Australia,1856,929,2785
1811,507051185,Western Australia,4230,4889,9119
1812,507051186,Western Australia,681,1543,2224
1813,507051187,Western Australia,3704,4732,8436
1814,507051188,Western Australia,9266,11483,20749
1815,507051190,Western Australia,1563,2048,3611
1816,507051191,Western Australia,3171,3541,6712
1817,507051192,Western Australia,1617,2391,4008
1818,507051193,Western Australia,1457,2287,3744
1819,509011225,Western Australia,9323,5738,15061
1820,509011226,Western Australia,915,438,1353
1821,509011227,Western Australia,744,460,1204
1822,509011228,Western Australia,1196,1289,2485
1823,509011229,Western Australia,894,190,1084
1824,509011230,Western Australia,1152,487,1639
1825,509011231,Western Australia,1543,361,1904
1826,509011232,Western Australia,777,528,1305
1827,509011233,Western Australia,1399,840,2239
1828,509011234,Western Australia,1436,740,2176
1829,509021236,Western Australia,1471,738,2209
1830,509021237,Western Australia,1194,334,1528
1831,509021238,Western Australia,1412,313,1725
1832,509021239,Western Australia,2599,889,3488
1833,509021240,Western Australia,1926,520,2446
1834,509021241,Western Australia,1584,289,1873
1835,509021242,Western Australia,829,177,1006
1836,509021243,Western Australia,3554,2161,5715
1837,509021244,Western Australia,802,504,1306
1838,509021245,Western Australia,1507,696,2203
1839,509031246,Western Australia,1289,340,1629
1840,509031247,Western Australia,1671,274,1945
1841,509031248,Western Australia,568,348,916
1842,509031249,Western Australia,1695,708,2403
1843,509031250,Western Australia,1599,394,1993
1844,510011262,Western Australia,2446,2528,4974
1845,510011263,Western Australia,455,620,1075
1846,510011264,Western Australia,114,166,280
1847,510011265,Western Australia,1098,766,1864
1848,510021268,Western Australia,654,503,1157
1849,510021269,Western Australia,540,369,909
1850,510021270,Western Australia,1890,1707,3597
1851,510031271,Western Australia,893,638,1531
1852,510031272,Western Australia,3404,2471,5875
1853,510031273,Western Australia,361,310,671
1854,511011274,Western Australia,4732,1867,6599
1855,511011275,Western Australia,525,187,712
1856,511021276,Western Australia,1225,640,1865
1857,511021277,Western Australia,829,596,1425
1858,511031278,Western Australia,687,611,1298
1859,511031279,Western Australia,5314,3201,8515
1860,511031280,Western Australia,1190,707,1897
1861,511031282,Western Australia,609,513,1122
1862,511031283,Western Australia,206,156,362
1863,511041285,Western Australia,9589,4674,14263
1864,511041286,Western Australia,674,540,1214
1865,511041287,Western Australia,1237,611,1848
1866,511041288,Western Australia,1546,856,2402
1867,511041289,Western Australia,1109,344,1453
1868,511041290,Western Australia,267,175,442
1869,511041291,Western Australia,1318,328,1646
1870,511041292,Western Australia,1673,610,2283
1871,601011001,Tasmania,994,2220,3214
1872,601011002,Tasmania,1190,1935,3125
1873,601011003,Tasmania,624,954,1578
1874,601021004,Tasmania,3352,5416,8768
1875,601021005,Tasmania,1928,2654,4582
1876,601021006,Tasmania,658,1235,1893
1877,601021007,Tasmania,1759,2531,4290
1878,601021008,Tasmania,1027,1871,2898
1879,601021009,Tasmania,653,1791,2444
1880,601021010,Tasmania,271,882,1153
1881,601021011,Tasmania,539,1670,2209
1882,601021012,Tasmania,709,1301,2010
1883,601031013,Tasmania,942,1322,2264
1884,601031014,Tasmania,457,1164,1621
1885,601031015,Tasmania,1153,2669,3822
1886,601031016,Tasmania,818,2032,2850
1887,601031017,Tasmania,3916,7846,11762
1888,601031018,Tasmania,240,518,758
1889,601031019,Tasmania,799,1917,2716
1890,601031020,Tasmania,1364,2593,3957
1891,601041022,Tasmania,3376,4961,8337
1892,601041023,Tasmania,1972,3229,5201
1893,601041024,Tasmania,1682,2564,4246
1894,601041026,Tasmania,435,1068,1503
1895,601051027,Tasmania,4729,9460,14189
1896,601051028,Tasmania,956,2445,3401
1897,601051029,Tasmania,493,841,1334
1898,601051030,Tasmania,653,1433,2086
1899,601051031,Tasmania,2677,2730,5407
1900,601051032,Tasmania,671,2273,2944
1901,601051033,Tasmania,675,2038,2713
1902,601061034,Tasmania,983,1965,2948
1903,601061035,Tasmania,3118,4666,7784
1904,602011036,Tasmania,744,1267,2011
1905,602011037,Tasmania,877,1044,1921
1906,602011038,Tasmania,10168,9271,19439
1907,602011039,Tasmania,1411,994,2405
1908,602011040,Tasmania,311,466,777
1909,602011041,Tasmania,1407,1969,3376
1910,602011042,Tasmania,865,824,1689
1911,602011043,Tasmania,1242,984,2226
1912,602011044,Tasmania,619,482,1101
1913,602011045,Tasmania,497,953,1450
1914,602011046,Tasmania,1021,658,1679
1915,602011047,Tasmania,570,857,1427
1916,602011048,Tasmania,2163,2065,4228
1917,602011049,Tasmania,1333,1369,2702
1918,602011050,Tasmania,973,1027,2000
1919,602011051,Tasmania,480,695,1175
1920,602011052,Tasmania,715,681,1396
1921,602021053,Tasmania,939,914,1853
1922,602021054,Tasmania,1554,1385,2939
1923,602021055,Tasmania,1342,1103,2445
1924,602021056,Tasmania,985,748,1733
1925,602021057,Tasmania,1121,827,1948
1926,602031058,Tasmania,1092,968,2060
1927,602031059,Tasmania,1538,1750,3288
1928,602031060,Tasmania,1078,930,2008
1929,602031061,Tasmania,969,918,1887
1930,602031062,Tasmania,1331,1268,2599
1931,602031064,Tasmania,1443,2078,3521
1932,602031099,Tasmania,256,227,483
1933,602031100,Tasmania,2177,1258,3435
1934,603011065,Tasmania,445,362,807
1935,603011066,Tasmania,426,717,1143
1936,603011067,Tasmania,1327,1574,2901
1937,603021069,Tasmania,597,1124,1721
1938,603021070,Tasmania,770,1558,2328
1939,603021071,Tasmania,807,1056,1863
1940,603021072,Tasmania,1651,2654,4305
1941,603031073,Tasmania,362,645,1007
1942,603031074,Tasmania,1158,1301,2459
1943,604011075,Tasmania,1089,1424,2513
1944,604011076,Tasmania,1189,866,2055
1945,604011077,Tasmania,4433,4608,9041
1946,604011078,Tasmania,780,783,1563
1947,604011079,Tasmania,1402,1230,2632
1948,604011080,Tasmania,173,264,437
1949,604011081,Tasmania,713,699,1412
1950,604011082,Tasmania,3432,2611,6043
1951,604011083,Tasmania,613,595,1208
1952,604011084,Tasmania,1615,1407,3022
1953,604021085,Tasmania,6614,6237,12851
1954,604021086,Tasmania,824,924,1748
1955,604021087,Tasmania,1429,1116,2545
1956,604021088,Tasmania,590,468,1058
1957,604021089,Tasmania,1571,1041,2612
1958,604021090,Tasmania,774,513,1287
1959,604021091,Tasmania,1489,1263,2752
1960,604021092,Tasmania,986,634,1620
1961,604031093,Tasmania,467,307,774
1962,604031094,Tasmania,1261,624,1885
1963,604031095,Tasmania,1074,621,1695
1964,604031096,Tasmania,992,857,1849
1965,604031097,Tasmania,945,1137,2082
1966,701011002,Northern Territory,5012,4844,9856
1967,701011005,Northern Territory,378,307,685
1968,701011006,Northern Territory,342,419,761
1969,701011007,Northern Territory,911,1084,1995
1970,701011008,Northern Territory,555,704,1259
1971,701021011,Northern Territory,464,644,1108
1972,701021012,Northern Territory,122,114,236
1973,701021013,Northern Territory,4521,5918,10439
1974,701021019,Northern Territory,819,1305,2124
1975,701021020,Northern Territory,712,881,1593
1976,701021022,Northern Territory,394,599,993
1977,701021023,Northern Territory,332,594,926
1978,701021024,Northern Territory,490,690,1180
1979,701021025,Northern Territory,202,434,636
1980,701021026,Northern Territory,657,1084,1741
1981,701021029,Northern Territory,714,1003,1717
1982,701031031,Northern Territory,710,403,1113
1983,701031032,Northern Territory,818,577,1395
1984,701031034,Northern Territory,2945,1635,4580
1985,701031035,Northern Territory,368,258,626
1986,701041036,Northern Territory,716,772,1488
1987,701041037,Northern Territory,644,653,1297
1988,701041038,Northern Territory,631,459,1090
1989,701041039,Northern Territory,329,453,782
1990,701041041,Northern Territory,4147,3058,7205
1991,701041042,Northern Territory,659,518,1177
1992,701041043,Northern Territory,634,532,1166
1993,701041044,Northern Territory,252,287,539
1994,702011045,Northern Territory,4184,4237,8421
1995,702011046,Northern Territory,327,506,833
1996,702011047,Northern Territory,724,612,1336
1997,702011048,Northern Territory,341,311,652
1998,702011052,Northern Territory,173,101,274
1999,702031057,Northern Territory,73,94,167
2000,702051067,Northern Territory,711,617,1328
2001,801011001,Australian Capital Territory,449,1552,2001
2002,801011002,Australian Capital Territory,9229,14260,23489
2003,801011003,Australian Capital Territory,473,916,1389
2004,801011004,Australian Capital Territory,929,1564,2493
2005,801011007,Australian Capital Territory,1114,2082,3196
2006,801011008,Australian Capital Territory,454,990,1444
2007,801011010,Australian Capital Territory,838,1407,2245
2008,801011011,Australian Capital Territory,534,1020,1554
2009,801011015,Australian Capital Territory,972,1785,2757
2010,801011016,Australian Capital Territory,1115,2069,3184
2011,801011017,Australian Capital Territory,472,1006,1478
2012,801011019,Australian Capital Territory,654,1390,2044
2013,801011020,Australian Capital Territory,398,1087,1485
2014,801011022,Australian Capital Territory,594,1209,1803
2015,801011023,Australian Capital Territory,539,1084,1623
2016,801011024,Australian Capital Territory,271,912,1183
2017,801011026,Australian Capital Territory,661,1257,1918
2018,801031113,Australian Capital Territory,53,101,154
2019,801041034,Australian Capital Territory,1111,1590,2701
2020,801041035,Australian Capital Territory,798,1228,2026
2021,801041038,Australian Capital Territory,708,827,1535
2022,801041039,Australian Capital Territory,591,925,1516
2023,801041040,Australian Capital Territory,637,916,1553
2024,801041043,Australian Capital Territory,186,226,412
2025,801041044,Australian Capital Territory,864,1352,2216
2026,801041045,Australian Capital Territory,177,166,343
2027,801041046,Australian Capital Territory,905,1641,2546
2028,801041047,Australian Capital Territory,1814,2146,3960
2029,801041048,Australian Capital Territory,1023,1639,2662
2030,801041119,Australian Capital Territory,869,1482,2351
2031,801041121,Australian Capital Territory,484,851,1335
2032,801051050,Australian Capital Territory,331,1581,1912
2033,801051051,Australian Capital Territory,485,1780,2265
2034,801051053,Australian Capital Territory,5757,11544,17301
2035,801051054,Australian Capital Territory,443,1372,1815
2036,801051055,Australian Capital Territory,216,918,1134
2037,801051057,Australian Capital Territory,670,2487,3157
2038,801051060,Australian Capital Territory,564,1949,2513
2039,801051061,Australian Capital Territory,510,1845,2355
2040,801051124,Australian Capital Territory,911,1247,2158
2041,801061062,Australian Capital Territory,621,513,1134
2042,801061064,Australian Capital Territory,524,874,1398
2043,801061067,Australian Capital Territory,444,946,1390
2044,801061068,Australian Capital Territory,2574,5658,8232
2045,801061069,Australian Capital Territory,871,1372,2243
2046,801061070,Australian Capital Territory,619,771,1390
2047,801061129,Australian Capital Territory,665,1380,2045
2048,801071072,Australian Capital Territory,504,826,1330
2049,801071073,Australian Capital Territory,794,1092,1886
2050,801071074,Australian Capital Territory,625,807,1432
2051,801071075,Australian Capital Territory,1352,1640,2992
2052,801071076,Australian Capital Territory,759,921,1680
2053,801071077,Australian Capital Territory,691,861,1552
2054,801071078,Australian Capital Territory,1343,1690,3033
2055,801071079,Australian Capital Territory,647,855,1502
2056,801071080,Australian Capital Territory,8998,9801,18799
2057,801071081,Australian Capital Territory,731,1001,1732
2058,801071082,Australian Capital Territory,2065,3417,5482
2059,801071084,Australian Capital Territory,806,1036,1842
2060,801071087,Australian Capital Territory,529,676,1205
2061,801071088,Australian Capital Territory,634,802,1436
2062,801071090,Australian Capital Territory,1289,1997,3286
2063,801081091,Australian Capital Territory,804,1405,2209
2064,801081092,Australian Capital Territory,493,1221,1714
2065,801081094,Australian Capital Territory,668,985,1653
2066,801081097,Australian Capital Territory,830,1643,2473
2067,801081098,Australian Capital Territory,490,811,1301
2068,801091100,Australian Capital Territory,709,1506,2215
2069,801091101,Australian Capital Territory,895,1279,2174
2070,801091102,Australian Capital Territory,520,864,1384
2071,801091103,Australian Capital Territory,632,1048,1680
2072,801091105,Australian Capital Territory,383,815,1198
2073,801091106,Australian Capital Territory,701,1103,1804
2074,801091108,Australian Capital Territory,808,1305,2113
2075,801091109,Australian Capital Territory,7122,8753,15875
2076,801101135,Australian Capital Territory,749,1350,2099
2077,801111140,Australian Capital Territory,55,57,112
2078,901041004,Other Territories,302,248,550
